"date (UTC)",description,moneyIn,moneyOut,"tx hash","current balance"
20170525,"PAYMENT RECEIVED",1554740453,0,4d175b5484547c32164e5d45d367c8c67aee7b86d10d3bc355a7cdda7a0c3445,97295362877
20170525,"PAYMENT RECEIVED",1770017142,0,f1983926c3c68d67a9f1c9a129a10869dd971b7570c4c4c187e1b9b0789579fa,95740622424
20170525,"PAYMENT RECEIVED",1553974752,0,aaf8b4b72858b8006553c781353ad0e6585908275948e6140913de83eba3269c,93970605282
20170525,"PAYMENT RECEIVED",1550272217,0,5dd9ecf3747dc37379bb109ae2c4d6c85bfc4e73cf3c6e270df12d7a701b3b48,92416630530
20170525,"PAYMENT RECEIVED",1492564130,0,68343df47ad6f19d797d9e91d02431e4f4f3e98b90c8eabe5d1a9f09f82017f7,90866358313
20170525,"PAYMENT RECEIVED",1520416121,0,20177719262242b8b5a501383c34b0611c4841cf68b1bdf86a446bdde3eecb24,89373794183
20170525,"PAYMENT RECEIVED",1572873393,0,2f7bd72611d5bc2cf25340136cffcea11019f02d1aef25f656a508bca95ee4bf,87853378062
20170525,"PAYMENT RECEIVED",1513917361,0,b5ea1bc689988a893574758087147794d51ca058c803d385d51e8c109f303862,86280504669
20170524,"PAYMENT RECEIVED",1610685584,0,02ba02076ff230cb45d163225e6ba3fdee40700a260d9dc7785778c830612e9b,84766587308
20170524,"PAYMENT RECEIVED",1465359256,0,a5afad450651285296c3359fd25f649320b303c7526f808c0ab2bceb152c78e2,83155901724
20170524,"PAYMENT RECEIVED",1537683529,0,602e2613c354d6b31a26910895d6ad10758579df50721cdb08c5b1ef7da9e406,81690542468
20170524,"PAYMENT RECEIVED",1428519721,0,e494a32c6a57a7800e38d931ec66d6129d6c04ae1dd57085ac6354da73c52cf2,80152858939
20170524,"PAYMENT RECEIVED",1456064392,0,b138a888ee498fd3c0b4d310d300f68f98b4b0485540ed549da69f65d955f7c0,78724339218
20170524,"PAYMENT RECEIVED",1426387280,0,208c095c97abd3b888202b392310ebeb0953fd6ccd8e5b247da907aa5e049ef4,77268274826
20170523,"PAYMENT RECEIVED",1429574063,0,7a1fc94586905100bb7599ecdbf64b1aa368291943314f6c14cfae7e648b472d,75841887546
20170523,"PAYMENT RECEIVED",1449840167,0,5f3822b8514533765258877ce1c733695bd13d0b4a0847b58045d73f3728f429,74412313483
20170523,"PAYMENT RECEIVED",1459261298,0,03793bdecd5db93f7efa780b72d698c21865c174ed936cbb8bf9a94d8da82f2a,72962473316
20170523,"PAYMENT RECEIVED",1448293311,0,f3febcd05bb231258c372a0a11ab3525302eaea01c731c0b76cbd326a86409c4,71503212018
20170523,"PAYMENT RECEIVED",1447149755,0,d2d4e84915e10c2da69119984a236dc9533d42c3ea33569161bf9ae35a0ecb6a,70054918707
20170523,"PAYMENT RECEIVED",1549775864,0,4c1c943a1e2dc42bafc6675c8ca092c73e8408be403bb634deeb58293ea9fef7,68607768952
20170523,"PAYMENT RECEIVED",1488375141,0,d8d607501b035c0051e020d77810c796b823f053ce6e0df6bf62ce1351e3dc06,67057993088
20170523,"PAYMENT RECEIVED",1586828632,0,34e9f949221bf608e2d8297326af97fb9a7c24611c7460c05ad61993224bf949,65569617947
20170523,"PAYMENT RECEIVED",1488339668,0,c253c275ffdc044bb2431fcc13059b2f46f6031133e6bbc0ffc5403d552cd0c5,63982789315
20170523,"PAYMENT RECEIVED",1505648547,0,411c38db0ca33a2087bba28fc5594e9fd45ebe6757de2b300348c390b4cac670,62494449647
20170523,"PAYMENT RECEIVED",1521913300,0,9e727566aed20833ffbb28336b63636ab938ea2f280bb843365146aeb6ea320b,60988801100
20170522,"PAYMENT RECEIVED",1552731464,0,fe316bf1178c58a08cbfd618da002432651c7b73521700f084770a6c56f13bdd,59466887800
20170522,"PAYMENT RECEIVED",1546358154,0,25e632d63821aaa821cd96cdc131dd3ec8067499a31a92f95e8b851950c054b6,57914156336
20170522,"PAYMENT RECEIVED",1624557834,0,334fb2780e61145ef7cd02234614bd558f85bdaf4398f024b9e5590d86ffe5ea,56367798182
20170522,"PAYMENT RECEIVED",1494693125,0,6dc5436b2b726c96d28b20ed708adee6998683f51aff2a0a278a194c34c7686f,54743240348
20170522,"PAYMENT SENT",0,-150000755200,ff4f41f3252e5aea6c5b98b43018ad45d0c8d643bbfc6cecf2f1af9792921c48,53248547223
20170522,"PAYMENT RECEIVED",1541306262,0,95c653b2debcac7081fbf5752472c35c81bcc52bd9ed52cc04e7556e9d92b14e,203249302423
20170522,"PAYMENT RECEIVED",1549159866,0,2b503c02422e7b83bfadd0f82e0f447bed7bfa7df158ad99e7a53f054c8c7ddd,201707996161
20170522,"PAYMENT RECEIVED",1538486177,0,bb232ac3fdbf7ca769d77a39dd2771863d5ef9ba2f52214f61996b5cc61a56d5,200158836295
20170522,"PAYMENT RECEIVED",1492958351,0,ebca5ec51e25fd945d9ddfdc6bb1d4d3973a201b0d232efc68303f002c72762c,198620350118
20170522,"PAYMENT RECEIVED",1495340852,0,b7a4318fb1cf498acf41db45e8a2f9221a6182aecf9fce30d8201650f53d2406,197127391767
20170521,"PAYMENT RECEIVED",1550709139,0,639b97934e4a5900fa53fb92bd409f12b974df66c0751e5e61ac541ea475894c,195632050915
20170521,"PAYMENT RECEIVED",1518299148,0,e4f24ca1812523f52fbc8870b84f669a04b1e44291b9e09df99c5537e42aa724,194081341776
20170521,"PAYMENT RECEIVED",1544940808,0,07c6d2dc8898e6ed0fcaa93015674ab9eb13ccbb5b463de7a0e14555cda54546,192563042628
20170521,"PAYMENT RECEIVED",1456563965,0,64b50fd34466774e3ff3d6bb09ba52027a16dcb17d37006abb06d0a4c5de79a0,191018101820
20170521,"PAYMENT RECEIVED",1472732362,0,7c71855dc5f55b0afbf26d91a9b45dfb9d1480ad9505a78058d5161c2a49644d,189561537855
20170521,"PAYMENT RECEIVED",1537071202,0,74de6bbbb2e94ff89e28d77d0b157e5cff42df5c1153d9d007227786f0e46513,188088805493
20170521,"PAYMENT RECEIVED",1388158515,0,f536bf3ef295462955f90e6b7091bc6b75a0f85ed92ae53370c9ea66091b27f4,186551734291
20170521,"PAYMENT RECEIVED",1416457541,0,f0e4356d1f7fd9ed4edf1c0c3fbe95696db7ff3abf08fb0bcab3e731f880071b,185163575776
20170521,"PAYMENT RECEIVED",1408260167,0,e4f7b710d42174ee0499e2c210f44e58bf644f158b629b26ab7df3ab5fe30e4d,183747118235
20170521,"PAYMENT RECEIVED",1446117053,0,b4c844fe93880fbf9e307b4bd6fb2a6517906e69e47cb041ac7b93f859ced02b,182338858068
20170520,"PAYMENT RECEIVED",1473733862,0,08c9493448ae870918a6194fd64e11b818c68ed0bb793db0a33dbce0c5ac45d5,180892741015
20170520,"PAYMENT RECEIVED",1524135205,0,52d222e3d1fab628c1294e7f94a0218f034cec000d073c23d9d5908a961dbc86,179419007153
20170520,"PAYMENT RECEIVED",1521408982,0,88fd4f2c05b1e88f45ff329b6e32fc2eeb9b470b494e8ad501514f03f42f70f0,177894871948
20170520,"PAYMENT RECEIVED",1465956845,0,120fb97dea3eaddcdb4b9e93de48d5634af94097f7961c9f419cde82b6a78505,176373462966
20170520,"PAYMENT RECEIVED",1443341688,0,87454e993cf4634e7e4c3e6320c5e3d9f7c821c0f0e4d880140521bf8e150e35,174907506121
20170520,"PAYMENT RECEIVED",1439123773,0,7ce13b7a381b1c8048e196ca480fdd252fde762ab5b5a5229a9a4778d5482688,173464164433
20170520,"PAYMENT RECEIVED",1404317959,0,f10aaeba0d9f1d439f4066f01ea6f8c8a3549852295b888b9e0d8ae52c697474,172025040660
20170520,"PAYMENT RECEIVED",1445770801,0,a40e787f48cabe1189db38c3fe30dfa069672beb4c5433d431f18b0796f4e224,170620722701
20170520,"PAYMENT RECEIVED",1485911093,0,54bd5ee27e085391edb6cf3d29d586387bbada221f793759965a570b8eb7e997,169174951900
20170520,"PAYMENT RECEIVED",1412473053,0,b294357b5de81c018eed906b747caf72a2ff36adcdb3b1dc2122b80abb36fb17,167689040807
20170520,"PAYMENT RECEIVED",1559456840,0,bdc40666a377d08bc0071f7fc5414fbeb75bc88b2d88424cdf7276d7d6a167ce,166276567754
20170520,"PAYMENT RECEIVED",1366191894,0,6b6972bcdaf7e745b7fde8404b232bd1441a35455dc1218f99511ce12513d93d,164717110914
20170520,"PAYMENT RECEIVED",1390358016,0,133ba9ccb6fe7757f36e515440b3ffc51865e334b9f3dc20aadfab62ce2896de,163350919020
20170520,"PAYMENT RECEIVED",1374575727,0,5c7e66b9af7edb446c9ec08f88e7fb7c8d0f59a0885d430d3ae60362c32677d5,161960561004
20170520,"PAYMENT RECEIVED",1447141111,0,aaa4430fa0e3b94656f5a782d7bcd6d8ea86e6b9dd0eab06d423a1aa7472b3eb,160585985277
20170520,"PAYMENT RECEIVED",1474880616,0,dcfa1119940d6bd6f7ef6b62cbaf0300127de3c81fbff20c9d03235b5320a48f,159138844166
20170519,"PAYMENT RECEIVED",1408222240,0,1dbe2a89a24c312c5ab852712dfba0153ff4f8ac52c9654863ad905c214c7d05,157663963550
20170519,"PAYMENT RECEIVED",1448924265,0,a04e11a4e213b8cc583a5df1d5d4866fadc7e5c66e720c1b58d2d71e33d215b1,156255741310
20170519,"PAYMENT RECEIVED",1559909389,0,f49a9ac0e3d33b533b7e3334ce8a9277dfa0601fba751ca9cf4de6e67b9a105d,154806817045
20170519,"PAYMENT RECEIVED",1550071948,0,1ea2852b3f1f25fa732e9b064fff9cf1d61e08bd12c59d8cde373f459b22fbc4,153246907656
20170519,"PAYMENT RECEIVED",1504166575,0,1af20e63113e7109c86dfcc01bcd92b737e58a3ea06674948e6e05d94315170b,151696835708
20170519,"PAYMENT RECEIVED",1660492469,0,e447b6932f2f4e0fed14c5870ba8a49168dfe9f8303fad1258c6086ae9271747,150192669133
20170519,"PAYMENT RECEIVED",1506673357,0,bb00ece49ee1d4e396c029c3c49e2bcd9b6f52d53141eaea42e5af432eabbc20,148532176664
20170519,"PAYMENT RECEIVED",1552026624,0,7a58b9176861e53aba0d928d8d4c2a37afc4449e108eaaa5525d9875efb0c976,147025503307
20170519,"PAYMENT RECEIVED",1469415087,0,613ed28bddfdaafa6b15f4e316e0cc9e9ab1d519600fe0ce1787d8a234abe007,145473476683
20170519,"PAYMENT RECEIVED",1488695853,0,105b2305c7628bd8977946d5935a52cd3286260ec7a7bb021e0309f9baeb55e2,144004061596
20170519,"PAYMENT RECEIVED",1560225671,0,8f9351d24cbbcf2706c216d88596f41114ac54ff63528a2d5a24dffc0ee7b4e3,142515365743
20170519,"PAYMENT RECEIVED",1705296334,0,404663cb4b23a988d2fbea3b07f32c8bb8e6ec1534fcd66160ad6e24315188f3,140955140072
20170519,"PAYMENT RECEIVED",1534844147,0,29ace3bca30e0d9959f51bbe5627927d778a786993b02cf7191d7ba74097b2d5,139249843738
20170519,"PAYMENT RECEIVED",1478281763,0,979ef6d90db2cf777a082e1ed66bee702c816c4b287b2d2ed17b52635cd0e918,137714999591
20170519,"PAYMENT RECEIVED",1573628527,0,d839693cdf21a9acbe6d69cb7baea862a527ff9b21fe2f3664953bc6c235c33b,136236717828
20170519,"PAYMENT RECEIVED",1621993269,0,c482e4b90b02180d89e70adeee7a48d454363fc79090cc49a9a8eac0dc47b99b,134663089301
20170519,"PAYMENT RECEIVED",1503796802,0,e4161f336d5fc566957b850267ac99abee8191aae2fdfe6f3fd1a7d09365f0d5,133041096032
20170519,"PAYMENT RECEIVED",1515499116,0,396d72e6a5b93d946b8c1abc40d9e8c4fcc13d066b5a9f13a945c0606dc5ad9a,131537299230
20170519,"PAYMENT RECEIVED",1407672916,0,a3175589a4121d41e8855b94ae3255fe82236087294daf5e5bf613420406b1bc,130021800114
20170519,"PAYMENT RECEIVED",1566314044,0,11d8b4c1aefca12a7949d72d9a380b1e402ff4e03a1e700aec289634f828b07b,128614127198
20170519,"PAYMENT RECEIVED",1514275650,0,3d659a3e630efca6c4fcf1fcf42c5a2482c9057beefd8f4d15a97d106de53800,127047813154
20170519,"PAYMENT RECEIVED",1508179606,0,98f45b25d19b59461d36bd93d215b89c7ad6812c5f7c812afd0ed42bf150a4cc,125533537504
20170518,"PAYMENT RECEIVED",1626416116,0,ee417ddd425387824289c62d198da04b98bff1bf6466e0d3df112ebd621af89a,124025357898
20170518,"PAYMENT RECEIVED",1548921136,0,0b032b42c3ab0c44f0d0bd91fc3b2942f3f995f93572c687af02c1b469f3ca48,122398941782
20170518,"PAYMENT RECEIVED",1552660088,0,22e7a5e107597247b7ea422fffbf22f8d78b4a8ef5c3f7e559aad90d7eb15ea6,120850020646
20170518,"PAYMENT RECEIVED",1504176950,0,c15db902f67dd72ddb2b6164e2c7f3f30a61381d455eeefbe1f622e72ced0ae8,119297360558
20170518,"PAYMENT RECEIVED",1641533100,0,b7f8d3f9eac511772ea655e05b356829fef04178f30ed6e319983668670bd078,117793183608
20170518,"PAYMENT RECEIVED",1659718680,0,a12019291449b185b6081d7ddadc35381aebaa4820d41dbfa34b2374774ade16,116151650508
20170518,"PAYMENT RECEIVED",1467079331,0,5f53cf54c950804d6f5c555073f8022ef8490bcb85191a5b031603baacfc29fc,114491931828
20170518,"PAYMENT RECEIVED",1575525265,0,a4ed27f1fbf226abd3a3ab608f3bf73752f2e7860b55953f5150ef9d6b281f91,113024852497
20170518,"PAYMENT RECEIVED",1472901494,0,ae9f9c32d30e2bc365bc3b9e0929461ca1e928e8a4fbe97058e79595bc345b0f,111449327232
20170518,"PAYMENT RECEIVED",1478644775,0,33cfb6663f155e75fc09fc4b6fa46aba11a2b9a47f28a8c289c7ac29f6a1672c,109976425738
20170518,"PAYMENT RECEIVED",1400849512,0,d7e51d27b19e623b15677a5ff50e1fbe784adb999d73ef9cdc8b81637bea0d0a,108497780963
20170518,"PAYMENT RECEIVED",1377823314,0,7239993d594f42590483a29527a62053672a9df2aaefd0ed976b2830ce5c1623,107096931451
20170518,"PAYMENT RECEIVED",1517429944,0,eb8f62d8b9a92c89f65655a2b0dd19b75415b7d1e21e2b5b734c6134a5ddc18b,105719108137
20170518,"PAYMENT RECEIVED",1561017597,0,c1d19b3f47a9a846d1c35b84aa7798d483a41cba04dacf0b18a74fba873ed582,104201678193
20170518,"PAYMENT RECEIVED",1459128412,0,b9920bd85b0f2becfd883df4be5e917fc95db212cae0f1427b5962725192c439,102640660596
20170518,"PAYMENT RECEIVED",1447358286,0,b39b3d992115f792490721ff58775ff9756b53caefeb707d51bfe90a32c294ef,101181532184
20170518,"PAYMENT RECEIVED",1654218980,0,2317c7f0dfd003f56e98d81021aa626f08e628a56a1cece64a169ffb28993071,99734173898
20170518,"PAYMENT RECEIVED",1463381634,0,534057a74ed9917bf452d9e12f605aa980c7e5c68344d0fa90e697f955f3656a,98079954918
20170517,"PAYMENT RECEIVED",1703893221,0,3e52f81d7e82f98ae3206cf5eeffec9a72ba7f50948e605f18f68244b55f5eaa,96616573284
20170517,"PAYMENT RECEIVED",1493897726,0,6e81953584c9c848620f04ef7933a0d93aac7062b1842593ccfc20849a01f132,94912680063
20170517,"PAYMENT RECEIVED",1675052171,0,8bfca12f5303904563d2546a3fd33f3c530fe0d71c381204588879d81d96e63c,93418782337
20170517,"PAYMENT SENT",0,-2869681408,4a075210379f496c0aa4d4ea42df43480c852ba64c6d9d9ff8407abde87b0e91,91743730166
20170517,"PAYMENT RECEIVED",1554823230,0,1fdc43a5190f226fd2b8817bb26182f0d769bd418a3064bbc70a76c73a5ab92d,94613411574
20170517,"PAYMENT RECEIVED",1538977442,0,1edfc0a7de9d14faa7d209aa5c2b0217fbf693c289a0c62e4c862a17c092cfcc,93058588344
20170517,"PAYMENT RECEIVED",1652811438,0,a1a6c020f6574d2192e66bb2d3b069b77dbaf4e272642b2bf2e8f4170ef892f3,91519610902
20170517,"PAYMENT RECEIVED",1484305705,0,bdc76e44784267620d6ae32f56115c3e12e6f415f1557d5c604fddb114c53472,89866799464
20170517,"PAYMENT RECEIVED",1422876480,0,d85480aea1f48ce11770f6334222ce4c6cfc1602e83b1d9283b463ab7ea6f5bf,88382493759
20170517,"PAYMENT RECEIVED",1423828914,0,3f78f023722b2b6c7f40e4a774f583f5e784202c5d9010ae08d11b85eab7ebd8,86959617279
20170517,"PAYMENT RECEIVED",1494705296,0,c7dd238badf4df3caeae942be7046e6dbbbf1f8f51f9facf8753014668d9b6b1,85535788365
20170517,"PAYMENT RECEIVED",1623895762,0,4a7e2965420f5405c6b1cf8c15c06cf1c308e6d6ee9af7daf6cf3c48c8cb7d7e,84041083069
20170517,"PAYMENT RECEIVED",1398088563,0,9f6c3df090fed8a2a4a0ddd3d7b1a8ee270c4019a37da3742e5cb845a1f471cd,82417187307
20170517,"PAYMENT RECEIVED",1488361584,0,e55214089a7f6f5d5e95bca2a65a99308f2fb1560194cb0da94bec05cdf52802,140454924074
20170517,"PAYMENT SENT",0,-20196682623,1de9d6837db39fa01f549be62aa17116722bd846f46591fbbf11df0c58854465,120258241451
20170517,"PAYMENT SENT",0,-12348546335,9c96604214c6305623e56f1b2c509cd9b64be04c207b062d0ccc327f7cd1a915,107909695116
20170517,"PAYMENT SENT",0,-10098345911,5f2c7779bb3a5d8b71d6f8fefad10b427e1993ddc4fcb15a29256d708947006b,97811349205
20170517,"PAYMENT SENT",0,-6693904549,92f150d744e852b6a7f2c28ad99de5600b173df7f1b69b562d5a4b79916900c3,91117444656
20170517,"PAYMENT SENT",0,-5049172956,60721156c17af873b15c9c361552da7a7708da08190453569898e467cdc0078e,86068271700
20170517,"PAYMENT SENT",0,-5049172956,80263f6e7ac722dd2b273980d82b2147da17d6bb4e363cfd6211b06f615cb742,81019098744
20170517,"PAYMENT RECEIVED",1599307369,0,c6656f99966226036cb8501ab2dd69e1df22c29cf9757c12b391d63097ccbdd2,138966562490
20170517,"PAYMENT RECEIVED",1513167596,0,098df2e30a135ba66af6bfd47b35812b2f99b9483a1ae536601d518401c525ba,137367255121
20170517,"PAYMENT RECEIVED",1453832699,0,d41cfc4de67e0481b76818d9fe21a61456c6d237f5301beda31d92bad279d207,135854087525
20170517,"PAYMENT RECEIVED",1592948432,0,a85e2540e09dbb012f21349c315ea84b70e7e57e705d71fef5462e309c41eba6,134400254826
20170516,"PAYMENT RECEIVED",1536604312,0,d4d8801a5a85b3d9a70c99eafd51a4a08f11d498d0af4a832817b74fe1ca1fcd,132807306394
20170516,"PAYMENT RECEIVED",1542980836,0,9b83e3ba64260240d62db15f263b03ce3c524d2c62dbfb616a213f64dce730b3,131270702082
20170516,"PAYMENT RECEIVED",1371927757,0,3fb7eb100ca0daebbe0dfff6a30ceb0d80edf53e7c15aea3ecdca5662f921fa1,129727721246
20170516,"PAYMENT RECEIVED",1490137022,0,51a6ed80f1fb5f164abf9336b5580938b60de07bc1a9427a702424fc9204bf36,128355793489
20170516,"PAYMENT SENT",0,-150000802400,62455168e4feb1a79c0e79fdba510df21010253109bb7777dbff4317e7ca3250,126865656467
20170516,"PAYMENT RECEIVED",1408293303,0,bdfeed117ad8aff1e666260a7faa7fccb11d0be0ab4f12775d81fad22127fed2,276866458867
20170516,"PAYMENT RECEIVED",1507340055,0,25d928138b62bdd75f5e4335947e11ea9c62b1689ea8ecdc5334de405a65687f,275458165564
20170516,"PAYMENT RECEIVED",1544934554,0,04e489d231caa32e235a2bc725f62fb8fb3177dd211bdd250290203ceffa07f3,273950825509
20170516,"PAYMENT RECEIVED",1422315354,0,5ebeb4c4290c6a3c14941bfd6a95c5d3cab51d084e36a171347b49265abab467,272405890955
20170516,"PAYMENT RECEIVED",1468527433,0,8ca6bcf225f6aca51594fcc499c076c7de5ad6cb52c1a8287e16f01153af9e27,270983575601
20170515,"PAYMENT RECEIVED",1439896745,0,ff21263516722280c646ebf472b9b1661b59242e4edee4d657aec69cf4161957,269515048168
20170515,"PAYMENT RECEIVED",1401504240,0,928f200c91d76decf05da4ba49483e2d23a2c93e0a86c2d8703b7a64ba5cc7b1,268075151423
20170515,"PAYMENT RECEIVED",1531454704,0,842e92d99699c55280becdbec57e5fab85ad4ed312cde3e65be5b4e8a0b21e3c,266673647183
20170515,"PAYMENT RECEIVED",1412498197,0,00e674455bffb14d157f59bf4afecdc108531ac2d5af41261691e3acb60cbc8c,265142192479
20170515,"PAYMENT RECEIVED",1418121237,0,796e9dc2fcc65eae6a220697ef2e27b8696240610d6950897c5efb2e114c4bfe,263729694282
20170515,"PAYMENT RECEIVED",1587241003,0,02a15ce7e1cc45af597982023dd4391452217f0aebf4a0d79c04e421a6ed607d,262311573045
20170515,"PAYMENT RECEIVED",1488670541,0,7064e21c5443d64906c597dd6f506541b3989c8adb617e1c262d2e8ca80cb83a,260724332042
20170515,"PAYMENT RECEIVED",1417559311,0,576be61287a3239e4e81edd71eed31e9f0854e721d8d8f80b58dc0899593bc1c,259235661501
20170515,"PAYMENT RECEIVED",1496000159,0,ee02c3cbc0ff91c89acb22bf953547eaab1f613804eb62d8d445c8202ed79725,257818102190
20170515,"PAYMENT RECEIVED",1447805416,0,111b8863cfa55b3cc0b03547d4886bf5514a4f56f80bbf36ffd07c0deb8728d3,256322102031
20170515,"PAYMENT RECEIVED",1539219292,0,a0a6aa45bfc40338249875b025b2856838654202c57fa6e7339d34749db82189,254874296615
20170515,"PAYMENT RECEIVED",1578489824,0,ce9d1b4f6854e9e093b682e5a96814d183ff7bd7badf3059f3cd7a5fc3703913,253335077323
20170515,"PAYMENT RECEIVED",1383749916,0,f632b7d7f9d809e2bb23335abc3ba8f04a414202b763de195e93f0c6dc2bebe3,251756587499
20170515,"PAYMENT RECEIVED",1350249276,0,c6ec2d5a0eebca71f88be6da38a9befa3ab23597fc42a404f9c246558cd6e167,250372837583
20170515,"PAYMENT RECEIVED",1353901673,0,0d2b02de7a7e6bfe87fa213261dd5d8182d6706aa25014549c2c2a1fa37bbff1,249022588307
20170515,"PAYMENT RECEIVED",1418109817,0,27b9cfd7c5dc0857ea90ccca7c6a35632144f1f65fea8113b230d7a6e5a05bc8,247668686634
20170514,"PAYMENT RECEIVED",1416939188,0,51b54486c6ed11901582d4c20b87a225d7eef6e8e00c89b0515206dc68973a8f,246250576817
20170514,"PAYMENT RECEIVED",1421603865,0,912763aca22d0405094011dbe9e6b09f5295084a85c21dbbd63da2a1e64d4e55,244833637629
20170514,"PAYMENT RECEIVED",1429657874,0,ae7bbef8913eae0e3fa20e3934a1427e54ec439e2250b83b3bfdfe60d741c1bb,243412033764
20170514,"PAYMENT RECEIVED",3000,0,41e14eedd7092aa0d01e3c60281a0638b0fca91522acfe7b54a39a9ecb25ba6b,241982375890
20170514,"PAYMENT RECEIVED",1338491386,0,0a59d9237ac3237e55fea8e6e26dfec44ee1747f3c284b056d0942d86c09e5df,241982372890
20170514,"PAYMENT RECEIVED",1427661915,0,b99569e1d612c6bd9ae1aaa8aee5c9c851cd5582e0e3c2c2e2c59ee733f88283,240643881504
20170514,"PAYMENT RECEIVED",1462330852,0,5aa5ef925a3cfa856b2ca9a6d26f029835dcb242c32756c309028a28031818d5,239216219589
20170514,"PAYMENT RECEIVED",1445961939,0,f2dced49ef6e61b735b30fe0e548cd60f3f85d49bfb95bad8b09c5d4deac1f07,237753888737
20170514,"PAYMENT RECEIVED",1399957700,0,d79ae1d2f4092feed185fe03ae67ff47b6fb44ca49dee584308d84a011f2db51,236307926798
20170514,"PAYMENT RECEIVED",1406977325,0,0f5e4b785020952ff059fa30bf6b679fa52e16b47789ad0c3f7b31e750787e3e,234907969098
20170514,"PAYMENT RECEIVED",1513093486,0,a848d0b6a58bf9a33b13cabc1799c28c6d17a12f6ba874da53b2975d5907a11a,233500991773
20170514,"PAYMENT RECEIVED",1395140756,0,7a80251696e049f78e1d498a8ee9a072f1b8b66f74ce67c7a3fd4b89a2e468d3,231987898287
20170514,"PAYMENT RECEIVED",1405119149,0,03aed91a7b6b33f3c064f98d275faa4f627b4258ea359e014d8e4424f03fe11b,230592757531
20170513,"PAYMENT RECEIVED",1383822905,0,90ac0795971b59971624be76138b838586cb22c70afbc25e76a564f6a28a2253,229187638382
20170513,"PAYMENT RECEIVED",1388341540,0,fe0483d71d7015bbc13f11db9ee356c4e131050b4cf8b87072b950db7a6cce19,227803815477
20170513,"PAYMENT RECEIVED",1426391307,0,2b497da9a1a718b928d2d4a6005e25f786c1fdc25a24a574c33fec0eb35aab09,226415473937
20170513,"PAYMENT RECEIVED",1417693587,0,511248ce7f62646a8122e7a7bcfbabee2508b7343ed16d00fdb22d498a96197e,224989082630
20170513,"PAYMENT RECEIVED",1444427006,0,5599afdb208215e2fef4cdaadc2262983c334f67cadb824ac43a083dfc455cb5,223571389043
20170513,"PAYMENT RECEIVED",1508509036,0,0323741ea67a6b9347ee0e29cd8dcd7ebc505a566b30f8c505bae06342532178,222126962037
20170513,"PAYMENT RECEIVED",1410773392,0,5ae4e0dce257c18b6d7ea6eed9d1c7d323b8f1b74e41215cc4e53320a36ea380,220618453001
20170513,"PAYMENT RECEIVED",1398381793,0,06ee7821f9a0005d2bb6a7744e77d90f6c59270c66c25d5f5cb19acd06f2bcbb,219207679609
20170513,"PAYMENT RECEIVED",1493647549,0,f73587a9109f39c041636a3fc78f86ddacc911aea7282d53ebff162ea4bcb6e6,217809297816
20170513,"PAYMENT RECEIVED",1512424593,0,db3c39def66f21eac9d88bd90529d00d7afa4a4bac48984d84582bbe9e2aadc2,216315650267
20170513,"PAYMENT RECEIVED",1536319805,0,c4aa2b564a1845c45d3ef314a15076d622a95963b7efcfdb3cbdde1874abc344,214803225674
20170513,"PAYMENT RECEIVED",1352999233,0,cbdb6b472ad1e3efe12e15e3635cca50a451373c07f7edf6e059b1d5e02f5a74,213266905869
20170513,"PAYMENT RECEIVED",1409644260,0,430b0eddd7892846bec924511c1fc830ef117eb1a46ca62e3419e49d3d7c267e,211913906636
20170513,"PAYMENT RECEIVED",1446075021,0,8b22ded3a35f3347e977031d0c6fea7adb3210c400616f1ea44c62f2c08ed8cb,210504262376
20170513,"PAYMENT RECEIVED",1393597844,0,34b9ca5bd3837ffdbd38c52ab74948f2657774e019918b0279af6dee5880d7b0,209058187355
20170513,"PAYMENT RECEIVED",1411946271,0,9a110ea6b0226884e5accf2093a90074104101e747a4dc74f1643b2b360bd98f,207664589511
20170513,"PAYMENT RECEIVED",1485052474,0,f41c86198768ee40a4c278852d0c673a7bb52d846b4417c9b9d198e2c95d25e6,206252643240
20170513,"PAYMENT RECEIVED",1568289931,0,886fa48e8673904dba70d1187931c794bb27d43de021880e4bab10c6ff3ff02a,204767590766
20170512,"PAYMENT RECEIVED",1512760895,0,903e7de6e3441040ee550dfd9d07ea7d0ce3ee1553335e7e7cde68cb2390c6ee,203199300835
20170512,"PAYMENT RECEIVED",1471427662,0,732f885aa15225c17684034aa19eda91d899bea464edf1914f5e801cccc114d5,201686539940
20170512,"PAYMENT RECEIVED",1399315814,0,96a666dc4245430f488e1a0ee8bc742971dfd9420544e80c21104e342a91b42e,200215112278
20170512,"PAYMENT RECEIVED",1416872584,0,2aea06f684b0a86faba3ddf1d75e2479ae191f98f3f8b01d13cdaeea3d883bf6,198815796464
20170512,"PAYMENT RECEIVED",1410845640,0,e504a3274c15e72248a1e208cfe05dd6835670c09fbf8fe321fbcd915e024bb1,197398923880
20170512,"PAYMENT RECEIVED",1390747490,0,2f94b2126a68f2fdec41cbed34750c75459383908a203cd35761b8e77295cf51,195988078240
20170512,"PAYMENT RECEIVED",1433522914,0,16b863596a6042864f8752e324a60ac6ed304945979df04fcadd8e00de3c58c7,194597330750
20170512,"PAYMENT RECEIVED",1426831130,0,83c5d0ac162b17bb6aabda854af5a2ee0f5485c550b04e832942405782f2321f,193163807836
20170512,"PAYMENT RECEIVED",1564781834,0,fe8bc140ce53bce4b6c58b2533a1b31d09f390a5d1cf78d4d9ba95f90ad102bd,191736976706
20170512,"PAYMENT RECEIVED",1408825119,0,8eaff0894d422e4e7d23529c1e787b33f77f56ccd1d22b375f8402e1b847d766,190172194872
20170512,"PAYMENT RECEIVED",1458080105,0,cb24da887913ace11ebbceb543716ac2f4eef052d80e5857354141de893a7dae,188763369753
20170512,"PAYMENT RECEIVED",1509740639,0,24c38524c2c7212e6e5fd82debb04588e5ed9d6b75ff45597873f18d96bc896c,187305289648
20170512,"PAYMENT RECEIVED",1366661404,0,8cb93605ea3e428141cffabafb37d9da2ce4915cf30a51e7161b4a0bc1ce9453,185795549009
20170512,"PAYMENT RECEIVED",1410106027,0,4b6a3950844708333360dbc0ac7f57e1505db9fb70073fb5a3675f83be9ef9bb,184428887605
20170512,"PAYMENT RECEIVED",1432278597,0,633a0452e3d71d13f554983d90e99db752e743e8efb1a2ede8b7bd87af1d1d5f,183018781578
20170512,"PAYMENT RECEIVED",1446791289,0,cd2e09e90b8f4c27f6320696e22481ea61a3b9c53a2a2fbbb3f771924765e6ca,181586502981
20170511,"PAYMENT RECEIVED",1479316170,0,694d52b6edd4333ba7fa23007974d655bf06be56c52834106fe8e3e046f68675,180139711692
20170511,"PAYMENT RECEIVED",1616573383,0,e258ad2e4c13d14f832fbb9276dd58a8b74ed078688a8f2f0f246b6b9501f6e0,178660395522
20170511,"PAYMENT RECEIVED",1513152845,0,9e37319c3357278fa6075d12d26a983c22bece48d8a5f4bf304e227bbe60d6d8,177043822139
20170511,"PAYMENT RECEIVED",1577898863,0,1db3a703801915fad93b9b29032bff10319ba5d3b9bccf667d35e1bc5a4dc718,175530669294
20170511,"PAYMENT RECEIVED",1578599169,0,5ac64fc1e7f65dec3376072a41cdc86d6f767c7fa0d039d5fd6b0417ef20f4bd,173952770431
20170511,"PAYMENT RECEIVED",1499647035,0,07c4f49b56d5a2340e040a4cc81fa4d711498b84a306e5d34e3509ca7e54e580,172374171262
20170511,"PAYMENT RECEIVED",1444091206,0,6d996615db90eb3144882b35d307c696ddba3f94e1b05e9f941adb2d4ba7b82c,170874524227
20170511,"PAYMENT RECEIVED",1412454124,0,355e22eb3ee6c4beef375f827ee438008d809350a2a6dd3697d084f43504d6be,169430433021
20170511,"PAYMENT RECEIVED",1466750993,0,538e334d4a01736f2ce9d0db46434af8ce47f8363d1a182d6f2d7767b40f29f0,168017978897
20170511,"PAYMENT RECEIVED",1491553966,0,230f4af5ae9c070d0ca2a5f7637d6c7a54cd3fcd97e65044d9e2c2ea38591c65,166551227904
20170511,"PAYMENT RECEIVED",1419068960,0,a8f2aa55c9c513357da2fc75386e2f60c3e0d29998a1dd2ab8b51ec13f07ebb3,165059673938
20170511,"PAYMENT RECEIVED",1393251796,0,161aff1e611a09a74f251a1e2f9b81293f5d6a2ffc6eb2c9160c815af8f796c8,163640604978
20170511,"PAYMENT RECEIVED",1405349055,0,69391449183a788f2c1dfba80a936176743062397d78c80194e94ae9b55e9daf,162247353182
20170511,"PAYMENT RECEIVED",1414275807,0,a0af02fe673e0036c25d42b6f48388a4805201d262c9014425eea9c3fa65dd89,160842004127
20170510,"PAYMENT RECEIVED",1416506741,0,c088e2382ac5bde4942eea903a8e78f9ac0f4f8aeb071618d78baf367cd46ade,159427728320
20170510,"PAYMENT RECEIVED",1425761781,0,c08fe5acfe6bbc522da1b027673ab3f19a5ddb7bb356c9f9193ca573ab06472b,158011221579
20170510,"PAYMENT RECEIVED",1443122848,0,f1598e172a75b98a6dda45cc6974fcf2923a4ec54f1e2754803f8404c264d039,156585459798
20170510,"PAYMENT RECEIVED",10000,0,c4df16258835572632319e8ab4912c3cd4fc0a4294af6b2452dca58b669def8d,155142336950
20170510,"PAYMENT RECEIVED",1456322565,0,09b6908fc2a2925235748bb70a4a27026fa6c305cfc5348b1d161b3c8b5673ac,155142326950
20170510,"PAYMENT RECEIVED",1429328187,0,716f13fedca933c1e5a2d8a9c5f7ed54155d72e8be95fb30ef86bf8cb86df9c7,153686004385
20170510,"PAYMENT RECEIVED",1424826343,0,4e46593618c1534c5e2eb0919ea2973c033d0df11be4e7d0f6ebe52c2c0647bb,152256676198
20170510,"PAYMENT RECEIVED",1481296998,0,bee52dd849bf4e14d561da1a7553ff5f366bf256fc9efa0ca3f7800f852f47d5,150831849855
20170510,"PAYMENT RECEIVED",1524741444,0,c142418b278b58726935990ff9c27762ce2073b6ab404cdf321a651ed21bacc2,149350552857
20170510,"PAYMENT RECEIVED",1452125050,0,9203bf6dc3a10d0062753cfa3f19a14177fb147e8d36cad0c1e1c042d5d68861,147825811413
20170510,"PAYMENT RECEIVED",1437939694,0,29d7fbd6962e5b595c91e3357bcffb78afa98301f5df0e62f80916e47c9a1821,146373686363
20170510,"PAYMENT RECEIVED",1465458749,0,a0b1989c297a99d18f1981682d225dbb51c8ef7767014e9d496e71aeac4f8ae6,144935746669
20170510,"PAYMENT RECEIVED",1436606483,0,2af9f7cc3fa6ce737369f259d66676ed876112bea2d271cbf4676174069b5a14,143470287920
20170510,"PAYMENT RECEIVED",1388123901,0,4a383bc41a7fa8bcd428d043eb865bcdabbe021abdc1496f0cfc3a826c90a59f,142033681437
20170510,"PAYMENT RECEIVED",1425687060,0,e8aafaafcf41e4c2fb92e1a6f74cd1298fa178ec6abf74606199bdf46510fb27,140645557536
20170509,"PAYMENT RECEIVED",1441989011,0,91fdd3f631ebf6a4ec7b6c858923a6f68816a8786d26ad87ee06ee0bce5a2edc,139219870476
20170509,"PAYMENT RECEIVED",1423314305,0,9a44e7e077a82b6c0636f2fd4a5a264895edbedc10ba336a438d89cb0b30dfca,137777881465
20170509,"PAYMENT SENT",0,-100000519200,1a87ee1ce4422a9b0040de31b6f4a9ca25ae76cacfbd7c59ebd02010fba13da8,136354567160
20170509,"PAYMENT RECEIVED",1397065525,0,ca2f57dc4a78daf3242f2a1f89d36d9e0c24b073c31f51131c4e3f3289b63adc,236355086360
20170509,"PAYMENT RECEIVED",1368329707,0,11ae407934a8a463bca2de0dc1366b869a07a4b890301ff5622db139e1b7c6fc,234958020835
20170509,"PAYMENT RECEIVED",1464184469,0,caf378210a1f2e8375030ea7cd1c781a63a6038ed55a1dcb0fe24bcd1bd18be7,233589691128
20170509,"PAYMENT RECEIVED",1424455749,0,4c182ac7e0b902c3c8978d1b7cc465115bae5a41547fab45f849a8091cc27ea5,232125506659
20170509,"PAYMENT RECEIVED",1417778342,0,7a87c5f5f3f88dff1dc50479af7b01768cd12acf5e0fe0c5dd99fe2641185dc9,230701050910
20170508,"PAYMENT RECEIVED",1451405333,0,4a8d6456c7fda671970411988aba642b3870a12eedfeaddeef317aebaa4c822a,229283272568
20170508,"PAYMENT RECEIVED",1441283376,0,db3a23cbf9cf44fc3153d09964eba043ece6d379edd8ca77936986f7925e09f6,227831867235
20170508,"PAYMENT RECEIVED",1410582959,0,85c772c5e3c799629e2f388fae6df038f9aa3a77bbb0c8bb271cd9e34a26d8bb,226390583859
20170508,"PAYMENT RECEIVED",1436893650,0,0a0229a9dd53f25636f370f067d26fefa1a15950de7102550251a04879aebc8f,224980000900
20170508,"PAYMENT RECEIVED",1422198032,0,a64fd51b44dbe9e898dbc79a5f857c5500f238e4983a044628e2d5f819ca60c2,223543107250
20170508,"PAYMENT RECEIVED",1471169154,0,584d239bad19852d61ed65a956e10fd3871549abc216cfa3c7a28a54c9f73d84,222120909218
20170508,"PAYMENT RECEIVED",1359313161,0,fb5ee37f71505b4b262390b8755010f4745489fd824c0ce740f5b6f46f28b03e,220649740064
20170508,"PAYMENT RECEIVED",1356443406,0,50778eae7b86e565d2536f43cf4ba6498cdf16d16a50c98d505e7d158f2bc701,219290426903
20170508,"PAYMENT RECEIVED",1368197531,0,fdc7ae0ada92fd944acad95111d9399e8433f947075c66d6cee7217c5d28ebc1,217933983497
20170508,"PAYMENT RECEIVED",1423763207,0,3b0e2784a441b98c14d81c5fb1c9dc5498342629db28aa578c413945ccdbb636,216565785966
20170508,"PAYMENT RECEIVED",1364366404,0,e1fe75bd0dd9d5e91b4d5a2532902251b60a6ccd4ff3c730c0f4a737b86539ec,215142022759
20170508,"PAYMENT RECEIVED",1459413892,0,2cfb8b5e121bc2562a27b756911c584d5b663d725a6bd5c36543c68e4ad0fa3c,213777656355
20170508,"PAYMENT RECEIVED",1386571925,0,8db1f3aa12efb9da9b5f0e052113837869bfbf6802de7f387a15682cc49a9886,212318242463
20170508,"PAYMENT RECEIVED",1503366335,0,748b7b1c98ee055f3bdf7348f842ce99cf9460340bd9d783fd3565450c2490c2,210931670538
20170508,"PAYMENT RECEIVED",1434559492,0,e4533aea50067405071b08749aa462e002d853f0ee71bd838d1213e098aaf5fc,209428304203
20170507,"PAYMENT RECEIVED",1479709229,0,0d8d69587bff5a8a949415833844f97c2e0102814ca89159f12ec50d0b85d2ec,207993744711
20170507,"PAYMENT RECEIVED",1407569068,0,9739a5fe3f56f2a603648905610814d71daa85603eee5f481ce0b34c9801a644,206514035482
20170507,"PAYMENT RECEIVED",1411991324,0,b511ed451ce417fcc964979007ff1aa17f5db1677673e67969a6696bc70af40b,205106466414
20170507,"PAYMENT RECEIVED",1470514175,0,9f0e654cd9bb875d7cf3055c9bfa1d8f991467102d929b8d499e1a6e118c278f,203694475090
20170507,"PAYMENT RECEIVED",1384177173,0,4e90e05f84a085bde7b2f1e0b5e09b6b0af35c69bbaf01868574685d92f549b0,202223960915
20170507,"PAYMENT RECEIVED",1282041062,0,dc200fb603d158febea4ce46762fe83dbdf32b066bee771dd15734421b50688f,200839783742
20170507,"PAYMENT RECEIVED",1377156188,0,7e04d720964aa9bb30b37bca94d789427df7580ac0975aa756b85c09b4ba60ac,199557742680
20170507,"PAYMENT RECEIVED",1342233861,0,8e434266dfa813628f59aaee162c9fc9d5961e96e7c01cb3dd030e4e8bf32f72,198180586492
20170507,"PAYMENT RECEIVED",1466993799,0,04456bf3c83b32ff74b698e29ea03838391c27bac7395fd05098a1d30c698d62,196838352631
20170507,"PAYMENT RECEIVED",1372097480,0,d08d9efb989297d7eb9042daf4624bfddce98d147e92fcf9565c58268f634fb7,195371358832
20170507,"PAYMENT RECEIVED",1398528028,0,55941d421f61681a217d4c810fa77e2a084aab6035b38b06e1c54a6597188140,193999261352
20170507,"PAYMENT RECEIVED",1393447367,0,a337315125c71cde9e4bf851ce98308bbe423cf66549cba8a9c13496cb364717,192600733324
20170507,"PAYMENT RECEIVED",1410418006,0,960dd739c98be5384ae39f4b4c6fa150535a17c8b0a8a1cdc9db2b1215169be2,191207285957
20170507,"PAYMENT RECEIVED",1372923986,0,bb73e5774ea4c4ce1a5c5288f7c61598965cbcbacd491c134b25d877ca8ef421,189796867951
20170506,"PAYMENT RECEIVED",1403468618,0,9cb9465501e955ffc79d802a769e21c4604f7550d27f3488c4d9a77db9300a5d,188423943965
20170506,"PAYMENT RECEIVED",1395743156,0,0d8c843d03f719ccf706d892ac851a8ef96f17cedb19cdb45f9c6b2e3c690c1a,187020475347
20170506,"PAYMENT RECEIVED",1402897907,0,c6586b0c7e68921576193529215c1a820e9053a5c6348188aafade36c4ec71d6,185624732191
20170506,"PAYMENT RECEIVED",1358320165,0,6c938af19e0b003de2e4ba01b54bb8f1a616a68147c7bbded13547ffd26a00cd,184221834284
20170506,"PAYMENT RECEIVED",1362314866,0,eb1d056e13f9670502aabc7728adacfab1632a28c63c25f3f8da54a18ea6d97d,182863514119
20170506,"PAYMENT RECEIVED",1390350363,0,2fde3d21e06d292d25f173ccfe0e06e9876d34ed518f11aa00acedd6450885ca,181501199253
20170506,"PAYMENT RECEIVED",1619659884,0,08833b4ec18d6edfc2b0a522edb7677db2ba8b99dbbed761232e7f182e10d7ae,180110848890
20170506,"PAYMENT RECEIVED",1342563705,0,f690b8368b08ce9f10f09c9326d28d0f11e4dffaec0a2f713bd1ce93e161abd1,178491189006
20170506,"PAYMENT RECEIVED",1390206448,0,5bad83c06068a6d09881e11aec8dae19aaef40a60ffaad84e7525ff4f309a072,177148625301
20170506,"PAYMENT RECEIVED",1390583345,0,260f42899c73efd804347402d583f94479b09c38abdfc293367bfc38b56ff3b3,175758418853
20170506,"PAYMENT RECEIVED",1383573386,0,4f4d045ad085ab20189fd3a5dfe00bfae0fcf206f37a1a6a4910948379a240da,174367835508
20170506,"PAYMENT RECEIVED",1422283418,0,131c23d1e02d98358c39d0d44223bb128eceec2eb0cc712f12357bedfe87cab6,172984262122
20170506,"PAYMENT RECEIVED",1402197656,0,4410e53ec993bed3c77bab8fd9a12cf0f59ec46c0608f54965e3676abb151db3,171561978704
20170505,"PAYMENT RECEIVED",1433042518,0,86222573399815f94eadbdf02704e0e48ee2cc59b41341e4036f42ed2ca5eaed,170159781048
20170505,"PAYMENT RECEIVED",1453309430,0,3f312e83469ecff46e5b148316ac99ad4b9871af72f0f9b21b6dfb57e97f21dc,168726738530
20170505,"PAYMENT RECEIVED",1479857794,0,b167caff7ad9f953b167e9304918f3067ee24be4311df0832f76983e1a78366d,167273429100
20170505,"PAYMENT RECEIVED",1428473649,0,b4ad6e1d7e2871e85de95e5e9a4e04668a2e12eee9bb527c484a988ce2cbc26a,165793571306
20170505,"PAYMENT SENT",0,-3532215551,2cb6a9842870862405715b1000723dfba711354c2d1f432e0ac0c4d788124f23,164365097657
20170505,"PAYMENT RECEIVED",1447920743,0,28df7a00324c958e2f44d852c7e36d7af5416d652bb6cdd82ae06bc782923ed6,177681274769
20170505,"PAYMENT SENT",0,-9783961561,5f61104f48963e6c2b3ad680703dfab9ced6f6e32085fc31e1eace4f4e8159e7,167897313208
20170505,"PAYMENT RECEIVED",1400056960,0,ec04e4211534d956362d7e888b6411fa42ac502245e6c0084c8f1c7168efc1b4,176233354026
20170505,"PAYMENT RECEIVED",1406770646,0,bef27a2f56580dd1dbe49bbe62f3fd65ce7c5f78c5bbd775e8bb8a7adb4372e3,174833297066
20170505,"PAYMENT RECEIVED",1428303458,0,dd9bd320f295623a91dceb9f59af375cfd1a6bde79b65b31a998f133244e3753,173426526420
20170505,"PAYMENT RECEIVED",1355728296,0,9d93ca25bea3a05e7863e7b093b5cd6881d896bf1c0782e3c6a2bd611d17a4a3,171998222962
20170505,"PAYMENT RECEIVED",1420449115,0,50326ba7091340e2c8f71a8944599a0476131b0474c975d143df8a208aed45c5,170642494666
20170505,"PAYMENT RECEIVED",1464486067,0,d115ae9be8768e1216229389aeb095a4e4e6e45b44dca88598c1838e5fbf8c3f,169222045551
20170505,"PAYMENT RECEIVED",1456958864,0,a0e3ffffaeb5b224fafd7a850fe65318d558527abf97c855a24b2771ccb9fc22,167757559484
20170505,"PAYMENT RECEIVED",1423329432,0,8c97f92e85c8d5f52b82a02d3b7e12dd5f1fa0afa46706748b4bad6d724350cc,166300600620
20170505,"PAYMENT RECEIVED",1431985753,0,9f703f64ecd1194123944230346b7816525faed7741f458eb0def5053e59a564,164877271188
20170505,"PAYMENT RECEIVED",1421029667,0,27e51b10a54c81ce3862b35cff96641749816d3dc3773987dab37e5a05c8558d,163445285435
20170504,"PAYMENT RECEIVED",1409309228,0,fd517aa502d0ec8cd468401bc30a63fcf60d5d77027d841124ae58b2a7e2fc26,162024255768
20170504,"PAYMENT RECEIVED",1484173276,0,7d2ba3c3aefbb79312676b7fb0f3203b1968ad213f1de985745245893ba74cc6,160614946540
20170504,"PAYMENT RECEIVED",1448733696,0,3b7ae6e2d30d293af3ca80e0874359bdbb7d8e2bfd9155909f740fa3a1f55ae2,159130773264
20170504,"PAYMENT RECEIVED",1423288226,0,744bc915960062f3b60e08f1a23d20f357943e074354abb0f7d20cdbc7c08219,157682039568
20170504,"PAYMENT RECEIVED",1372715265,0,c2d12ce27aeca9f4090cc68bb940b00bfb97a761dfbe2fe2d9e2a8be16d802b2,156258751342
20170504,"PAYMENT RECEIVED",1400305431,0,b31217c4b120c70e4037a72fd2355c3c56e5fd804b23678a2f2200847cb0fbe4,154886036077
20170504,"PAYMENT RECEIVED",1367552687,0,f7bfdba44fea9e1bdee5a0f4374fec4d4701b0b635278e4fd5518802751ea926,153485730646
20170504,"PAYMENT RECEIVED",1394238495,0,c64456e3b7f58b77e29ccb6d34d6245e65136889fbaaa326c6d215e118c0ce87,152118177959
20170504,"PAYMENT RECEIVED",1384410799,0,38d627b2e3d78a9b9eac045970c8c9401af99103bb0da04dea7ab9cddcf817ed,150723939464
20170504,"PAYMENT RECEIVED",1409197232,0,ad373bd656e5600696d471c3f884d70b71901238c1ec969992b1bd2cfb48f356,149339528665
20170504,"PAYMENT RECEIVED",1401187366,0,df4927ada5b9915c51a34cb40ca5aa2279da7daf7500fda06a3097d8b07823c2,147930331433
20170504,"PAYMENT RECEIVED",1408141653,0,65b8477f676ad62ff72f5675bde82bbfd915d319249427906aef09fee455de20,146529144067
20170504,"PAYMENT RECEIVED",1494392521,0,63eb038d2556d1d43ac45dde897d918e115868f807beea2cd3e0f68c322acd19,145121002414
20170503,"PAYMENT RECEIVED",1425527881,0,3a32be5fcbb9844132c34a31dd69a1271ea84895fb1f4818550c88f9d8a03945,143626609893
20170503,"PAYMENT RECEIVED",1466036985,0,51012013e7ecb114b94945cbf7fcf7314f4c87922dbed6c8ac13064c56fac3ae,142201082012
20170503,"PAYMENT SENT",0,-200001038400,9073cb1be5ef76cdec2f2512c71b5ed69234f7fdcdcb5fa086d747d6d68df761,140735045027
20170503,"PAYMENT RECEIVED",1459471759,0,4969246f9668a2a0dd9d0f66f730866a85c319b6d205765b47671367fe3505af,340736083427
20170503,"PAYMENT RECEIVED",1475034450,0,f0b0ff419a8381c2a76aa5fb479bd52638daeeeca4b6abd3b8b21d7313ea875c,339276611668
20170503,"PAYMENT RECEIVED",1471476128,0,b0f4da4ebed01a110beef6aea36057e481706a02ff84b30b2d37963fc51f258d,337801577218
20170503,"PAYMENT RECEIVED",1362143340,0,67f0dfc46d709dec11f1868d35fafd1d768f86ffc479658eae16290e53e9d560,336330101090
20170503,"PAYMENT RECEIVED",1384708699,0,20a16aa24313e58d3559afc156560ee98825cf4dc77b9832d28cae62084e1866,334967957750
20170503,"PAYMENT RECEIVED",1468173171,0,cc2499d198014896d8a51df6a7a744df088095f02155306e7b4ae338fdfe1069,333583249051
20170503,"PAYMENT RECEIVED",1382607590,0,d3caea24fd8fde4774a4aacd75c8da570c52a62ff2772495cea1ac02844e7af6,332115075880
20170503,"PAYMENT RECEIVED",1457502279,0,68766d7a47f5b14c4248a8021fcc74b2265eb784f3010a9a81ebe59814f6232d,330732468290
20170502,"PAYMENT RECEIVED",1375022193,0,05e4cc11c3564b031cd55f2aa08c8fd4d8e8e4fc1ca2b93d621c76455b36c220,329274966011
20170502,"PAYMENT RECEIVED",1374918960,0,0f860c599ff655a6168b451a3dfd21e63dd12b3dc8b826b8bbf8c2c941c45027,327899943818
20170502,"PAYMENT RECEIVED",1568266916,0,c59698eeecd9fc34d8186881e90ae9ab62b7f0f751721ab558b7a60c01009d50,326525024858
20170502,"PAYMENT RECEIVED",1383306095,0,b524382c97783870b625b4f859185812296b0f33b6199d544e34f124e8d03eac,324956757942
20170502,"PAYMENT RECEIVED",1362908113,0,8173c73e63009388f33061f963d48a0ee136ac827dab0e3835157094690295e2,323573451847
20170502,"PAYMENT RECEIVED",1423242248,0,138bf6f6dd43f05b9b9991809afa3c98c8bc69dc370016cb5a373e41e6ddebd0,322210543734
20170502,"PAYMENT RECEIVED",1405863900,0,3570cb62d142ee3db77b1a40c0b99f296a67c91bb63dd0e24c9151de4fd29908,320787301486
20170502,"PAYMENT RECEIVED",1460687301,0,e488581506dbdc02b5b61e3cebae2d6eae4c20a93c7bacf3b39837585e49fe0d,319381437586
20170502,"PAYMENT RECEIVED",1393725634,0,2629e2263c5a993f446ca47bd5e4a69677d1f9fa55ea5b6f4ca6f47abe933882,317920750285
20170502,"PAYMENT RECEIVED",1376301220,0,b0990ad92fecbdeab97777c476f67ac916131423c445116faf18aaa45b3d69b5,316527024651
20170502,"PAYMENT RECEIVED",1364624800,0,acc16d522294708940b14eb0c8fc6267ba117ec091232684accd8226d160f605,315150723431
20170502,"PAYMENT RECEIVED",1421329443,0,2994344f0e66e11b0961b1aa848104bf70aaf9988ff153658702fe7e72f05dea,313786098631
20170502,"PAYMENT RECEIVED",1388105441,0,f2cb4f0be925441f08abc0b4b7e2e2c6e577742170529829a52558956deb844e,312364769188
20170502,"PAYMENT RECEIVED",1372980295,0,e46f495af84f652cd4423c95b424d667feaef06e99ef824f10532c21e84d01ce,310976663747
20170502,"PAYMENT RECEIVED",1403488138,0,6d205ea092db22ade95bedeb282b59a04c80e74f10f7ec116b31b337bd1dbf1d,309603683452
20170502,"PAYMENT RECEIVED",1444856975,0,a4b54bec514f85b41a0b9c7b57a00eb075ef1cadbc16519a74a348b0ff97f6be,308200195314
20170502,"PAYMENT RECEIVED",1410272248,0,f3f54f23dfb2a396ac6f66d2df648cd9640c8bf9bd900ec10ea68cce85ef7a89,306755338339
20170501,"PAYMENT RECEIVED",1388837007,0,7a95858438f0868927c18f66dbbf56cf396233c5f04cfbb3f86d0714de1f1f7e,305345066091
20170501,"PAYMENT RECEIVED",1381551578,0,010cc88ce7bd24935ad4de73b4f298063f368bb7995a6d6dfb5c22ae9e9c35e6,303956229084
20170501,"PAYMENT RECEIVED",1478023210,0,0840949b799566e63ec4284740c0628dfa0840f1059446a8f8f4702048121a0e,302574677506
20170501,"PAYMENT RECEIVED",1370677616,0,674af5c9fdd5596e2dcf7ce4027a3eec6ea5c6533d5086d7ae41e720154ac713,301096654296
20170501,"PAYMENT RECEIVED",1448325990,0,ffcb84549ac82918c1524a88a30382be65549d1f2367fc1735d359d5bafc6338,299725976680
20170501,"PAYMENT RECEIVED",1394600567,0,a17fbe1fb691df3c7bf8b52659c0cad17cdb633a4facd7727212d43b1d223445,298277650690
20170501,"PAYMENT RECEIVED",1365908582,0,87b6124b46e62e8a4ebfd85755eb960642eb2934eadc57651296f13b6f242465,296883050123
20170501,"PAYMENT RECEIVED",1322759955,0,947709ea4e2ece67045e35dcf073cc779f0b6c6fbbb6804e6baf438bf4470ede,295517141541
20170501,"PAYMENT RECEIVED",1325850988,0,04ce6d72bcd6e2e5840a871fb4fd657f62b0ca48ac2d1f7312c4f60609289d7f,294194381586
20170501,"PAYMENT RECEIVED",1342866922,0,79a9ec9048ff2dcd1c2ef77abf59f747d13307335664f7e4af2bfe64856d8b43,292868530598
20170430,"PAYMENT RECEIVED",1305921564,0,22b6c81b11c16e914c86590b541dd983f2ea2768e58eaca8091ad024480b9f4b,291525663676
20170430,"PAYMENT RECEIVED",1384775241,0,53abf31c9ece53611ef4a13eda24cb854c3844f4abd9a24d332839ab8256a553,290219742112
20170430,"PAYMENT RECEIVED",1367642452,0,dd83f8cbe8b27726d39cd8212c4b171cb6d0cc9b952b25f92cd581681e7ec8a4,288834966871
20170430,"PAYMENT RECEIVED",1363742791,0,e9210f82a9282c1eedd7c75e0b67816cd7d3cbf5fcbb02e6515c0f3b86938286,287467324419
20170430,"PAYMENT RECEIVED",1420345754,0,dca450871dad3a7a85a901cf21e16906f55b38f918086a8f24f2c5b1ef05f3e5,286103581628
20170430,"PAYMENT RECEIVED",1416872147,0,04bfcf36df1e97d8b76fcb6986627ff89fe92d5cdc9041dec942d73a01b49685,284683235874
20170430,"PAYMENT RECEIVED",1410489358,0,e5da057e6b5dd2a14e1046e3107562b164531a55a3bba23fb4cc4b5dd94e456b,283266363727
20170430,"PAYMENT RECEIVED",1416270005,0,9506a3d82d8fde43287a20b77246ddfb42a68ae2ccdd5491856f2e4a2341e449,281855874369
20170430,"PAYMENT RECEIVED",1341950537,0,9591851469f5fe394f81f16c444954aa848a54eea7b2d0b4af614b1030b52252,280439604364
20170430,"PAYMENT RECEIVED",1298450944,0,bf234daaaabcd64ab7738cdf23176d4199d1a83ba215a355649022fdc0cca9aa,279097653827
20170430,"PAYMENT RECEIVED",1278238231,0,f50976a6536043f52c8b115e3d4322f3c69dce54c465caf765963de13ab3227c,277799202883
20170430,"PAYMENT RECEIVED",1357754792,0,459c41c7cdb12ac7e75c6d241e315f89ae267a10926a1394c7913bd39b0b065f,276520964652
20170430,"PAYMENT RECEIVED",1372559475,0,49c4f271b2f454b0d7919451e655ea5dc7092854109cf32c48426d33a3bfe129,275163209860
20170430,"PAYMENT RECEIVED",1365727756,0,8ab2190be5e01cb15ab1597fd921b27a36c943d9296a9be40f22a114d39f4a1c,273790650385
20170430,"PAYMENT RECEIVED",1358785550,0,5e066864bdb8b47f20720301ac9f613afd9382a975aed3c2e053af6eb56b8990,272424922629
20170430,"PAYMENT RECEIVED",1411055126,0,18edb4b057a6168305863fbc55a17d7eb0053db58c9bfb0a3f1921a53cd3dd70,271066137079
20170430,"PAYMENT RECEIVED",1396130029,0,30213032383f361f07d6a0f300c44cde57663d9e931f80046d41a520167412eb,269655081953
20170430,"PAYMENT RECEIVED",1387041861,0,f2ac467cf46f60a83c08256b14c9516f1f91b0cd04a89068d0c948e7fa87f45c,268258951924
20170430,"PAYMENT RECEIVED",1428517776,0,15751f67a5ef2a3bfd882f1802a0cdfd29f93828a1947667a6a048d799a4d38a,266871910063
20170429,"PAYMENT RECEIVED",1364413872,0,ea770b22f2949bd8a6cc71b8f7b707568e629e8a249364e20fbd8bf95bc8ba45,265443392287
20170429,"PAYMENT RECEIVED",1374209834,0,8528ddf1c96c36d9f09fb39c43347445e71395e1cb6b68ee1195e3fb17e85c48,264078978415
20170429,"PAYMENT RECEIVED",1421293013,0,9c0abd2f9d88d77046b6073eb16786b8406c69b55e40c7465c286feffddebdf1,262704768581
20170429,"PAYMENT RECEIVED",1304464521,0,c4be34f0e944cc2d9a499990407ad8bbfeb2cfd569fa43871f7177b5a726489a,261283475568
20170429,"PAYMENT RECEIVED",1451404836,0,b9c2f8222ef7f3385e2dac32650a47bd1161208804c508d615dfbe089bcf6dea,259979011047
20170429,"PAYMENT RECEIVED",1337156177,0,dcff7c004ee81a053cf0cc670a81a0abbce2b8c4675dc23b470f5c51b0e60e6e,258527606211
20170429,"PAYMENT RECEIVED",1338186898,0,148cf6ff00bce4ff229bfded1bcbb4aaeb81c343571eda08e45b0d9dbd72236c,257190450034
20170429,"PAYMENT RECEIVED",1383468363,0,5e3851e14c8003fa3c3695ff1642910fd94e7b58da205b7fad4905212373c8d7,255852263136
20170429,"PAYMENT RECEIVED",1401406183,0,5602241d32f0b8a992772adf4d113023c86d63a1534b15fc2c5072e0ee09cb12,254468794773
20170429,"PAYMENT RECEIVED",1347691582,0,600a837ee511934da86e703f75467cb71cf797dcf37172ec74a94e855c328c46,253067388590
20170429,"PAYMENT RECEIVED",1365683956,0,35177c67392f7f98765ea4713b72649d135166500e44114148a0cf6b9d1cb20b,251719697008
20170429,"PAYMENT RECEIVED",1465353672,0,19038c5810499ce39294a1648a94032d293ef950d69484f85a80af148cf4dfe4,250354013052
20170429,"PAYMENT RECEIVED",1398911746,0,ecec43a9beb64baa702b1fec944f842fe4582408df4e96af7594658209c75868,248888659380
20170429,"PAYMENT RECEIVED",1464944045,0,cc0c8f5f41459405dbdd0179deac7672a30620fcdf3554ef444fb98d0be114cd,247489747634
20170428,"PAYMENT RECEIVED",1339662777,0,fb63fbcfb1255f9258b13036515259b694169c6f0b79095a8734b126e5e64622,246024803589
20170428,"PAYMENT RECEIVED",1403489999,0,98edb8886d3005dfa2d275106262f83fd914a6ae02e8295c1897765ffa6c376e,244685140812
20170428,"PAYMENT SENT",0,-2000009200,8c0dac5deaf999c1625e8616eb4c5ddd63441dd0864917c40ce4f05b54ff82a1,243281650813
20170428,"PAYMENT RECEIVED",1436524837,0,98adc4a14d4365c017a09716eb4db41fd00cfc71cc98fb871756b868cc9c4d51,245281660013
20170428,"PAYMENT RECEIVED",1504405163,0,6286efdb1cd30f00e30b8366f5ce1045aed3d54816aed8cbee0f0d62edab9ccf,243845135176
20170428,"PAYMENT RECEIVED",1482327301,0,82d892d00c2fb3984a41b069ecb26245e23e7fa6a5f8f144e2c60c111efd1699,242340730013
20170428,"PAYMENT RECEIVED",1415886116,0,cae693d04fd9405c27d445eacee731e831159b015f639e3934b2c565b3b8e2a3,240858402712
20170428,"PAYMENT SENT",0,-2342050421,492fd7aa61a2ce21f600622c747d6601aa7c296619422a448768fade47bb11db,239442516596
20170428,"PAYMENT RECEIVED",1427878479,0,5371ca0e95ca8114a1875042261a02ae1577f1a2dea2df829dd4ea02875d56b9,240378602410
20170428,"PAYMENT RECEIVED",1405964607,0,7374c0db3352415a821a5d7cf788f7e9c1668017d91d2ead2d0ea8778767bb6e,241784567017
20170428,"PAYMENT RECEIVED",1396544491,0,9d01cebee537e7f5d2949bed35994b77dde1be9db649ed125c98d05cc26f8ae7,238950723931
20170428,"PAYMENT RECEIVED",1370628664,0,da8c2de0af2d52fc0901258fd4414774daf1abdffb7874a88aad4dd493c6221b,237554179440
20170428,"PAYMENT SENT",0,-12954551588,1632be5a237f25ae62f7d2f15f86e62561477f2aa7f43f5fea8c506d857004e5,236183550776
20170427,"PAYMENT RECEIVED",1398424275,0,a97ccfac76cffeb2c5fa8e087f434aa5df5a965263363f3e52c42baee9bf5548,249138102364
20170427,"PAYMENT RECEIVED",1424271241,0,0f761a99e4898ab57370981f21333b284eeebc50de2ce1f742c3e8910c2f3061,247739678089
20170427,"PAYMENT RECEIVED",1476663491,0,1ab95c00298389f32d1c75133dbf0d195f0133556f156f64773cfb4913b4c11d,246315406848
20170427,"PAYMENT RECEIVED",1354046366,0,fb43fa52634acdd5f536c793cd2c16241f852d71b86f7838e1f570e4ef913eb7,244838743357
20170427,"PAYMENT RECEIVED",1375752457,0,c144d35c3f3740fb9312789b28909b93ed29729c28dd65767cbeb929c2aceeae,243484696991
20170427,"PAYMENT RECEIVED",1388355345,0,45f3422994e6431ddee614617ca9fb8019af5da3d5b180eec498e4effbea3724,242108944534
20170427,"PAYMENT RECEIVED",1442272296,0,31478a31f045ad189ac9e71b275dd54c4ba567522b66eda2ee7d13a12986df8c,240720589189
20170427,"PAYMENT RECEIVED",1416392976,0,d13c7c0c560398921261ab08a9aaa4a493d84af1bd324a664a12d1031a9a87df,239278316893
20170427,"PAYMENT RECEIVED",1383147221,0,334ade534d630da0a6ec8cca4020e8a0b8d7862a0b65c5b7413f6317ad327939,237861923917
20170427,"PAYMENT RECEIVED",1361774788,0,2954e1f021dc98cbacad40af8d614debf76600f26eba6bb308322962852e10ab,236478776696
20170427,"PAYMENT RECEIVED",1401861668,0,d9164a7660c2c5408d69f60fd2495b4bf52c03e5e71942a222dbfed928be5ab2,235117001908
20170427,"PAYMENT RECEIVED",1451074385,0,ec224eccf160c542530495de1e372f0441ecba25b13c19e768f5603004097b10,233715140240
20170427,"PAYMENT RECEIVED",1454698804,0,1f0d3e7a36ab0eb11c63ccb7e2103b4e4f774b5bd060c2a280762a99d2b12058,232264065855
20170427,"PAYMENT RECEIVED",1411969560,0,d40e99ef3314159ce090942da3ffe43d6cc76ae7d3c2b0a60903550cb6e980b7,230809367051
20170427,"PAYMENT RECEIVED",1403191012,0,54026de3641cfda56f0a7f67263fb5770f69fd42c1c761d88cf08d271b1ac88d,229397397491
20170426,"PAYMENT RECEIVED",1409716998,0,44e4b93e9934da23f71efe6bc71a798bb2208287a942d1f8df4ad29a28e82044,227994206479
20170426,"PAYMENT RECEIVED",1356828095,0,80bcab94ead91f7b7bddecc81a5dea79267f0987c47df9dfad0a1570909a8acc,226584489481
20170426,"PAYMENT RECEIVED",1430709963,0,12becff5da4745566c6eadf083046cb79e3d6d58effaa6d875119c195c954f70,225227661386
20170426,"PAYMENT RECEIVED",1414638462,0,57df1517db7800cc6b8369ae0589411703208e83afb04b21d838f0de2e1180f7,223796951423
20170426,"PAYMENT RECEIVED",1455733694,0,79214329cec5bcd63026662f14c29ecf34a8427785f2ee5d417668a8ea0c7501,222382312961
20170426,"PAYMENT RECEIVED",1532014703,0,bd8b73f762b225300360fd35507b3ff714fcfb530ec1cc6c262900d20a80dfd7,220926579267
20170426,"PAYMENT RECEIVED",1468060109,0,4d30d5fb0ec057a53028a1d6a302b163d698a52ad486c44a25edf5d020280ece,219394564564
20170426,"PAYMENT RECEIVED",1353400915,0,886fa2cd32e0325f90c90f5e8ea84d152b4e67169cb55042756ae6bf37f6fb4a,217926504455
20170426,"PAYMENT RECEIVED",1385360894,0,23b9f2ece154c6dd73e8a54a9fccf0663d8a93a288986319d127c432271c836b,216573103540
20170426,"PAYMENT RECEIVED",1351763465,0,3eb3011d6fa9862e89a66b54c9a8178eac8c55898bbeb1f674eb2ff5901319f6,215187742646
20170426,"PAYMENT RECEIVED",1420386855,0,270a2c6dbfb43ee73827b6dabf557bc30d83f9c2d3ba664a912237166bbb6bca,213835979181
20170426,"PAYMENT RECEIVED",1467405530,0,645728e438fa3f88bc45231b2d99c59170b1f8e6a2a14ebec18b1c1265defab1,212415592326
20170426,"PAYMENT RECEIVED",1355342620,0,4277a71011b72fdc59785233a0661f519d3661f476722ed8acaf4e6798b65434,210948186796
20170426,"PAYMENT RECEIVED",1413531229,0,bd9c7a15d858fa80e1f39ebfba6da6d2c3fb55c3cc33ef747770e658dd32da94,209592844176
20170426,"PAYMENT RECEIVED",1431925391,0,bf8ce420d9c1699f10310388c53b2e6790adacdffddb2b66985accfd761de231,208179312947
20170426,"PAYMENT RECEIVED",1420411622,0,7adb0f264df97c808a9cfa570da590ef63d316cea4e58911c3f81124fc610299,206747387556
20170425,"PAYMENT RECEIVED",1401960935,0,52e2987cf0140f217773f2eed4e2964c1d32fd6307782d8194f960acdf9acced,205326975934
20170425,"PAYMENT RECEIVED",1425112562,0,1317a2311724f8b7fc2767ff54fc1d19a21dd329968c38d6cf9a3298706943d7,203925014999
20170425,"PAYMENT RECEIVED",1422056659,0,324d7e5737b2fbd95787350ec9e0fa183b3a2737e4d601bfb7826697da194f14,202499902437
20170425,"PAYMENT RECEIVED",1495809543,0,efe8af9b54ee5cd111d9eee50945ed124e44bf2073aaae50cd12a5a1ad65f4fa,201077845778
20170425,"PAYMENT RECEIVED",1364422336,0,dbf7b1c5c67d97f8bc263050b6e57a6f83af55b8942a239ea90cad058e92b299,199582036235
20170425,"PAYMENT RECEIVED",1357469939,0,6760d5ba142125631c9898bafc8c85bebef9798022ddea3240bb1ad4fd49a826,198217613899
20170425,"PAYMENT RECEIVED",1402706341,0,c8aa092b324fccfb091f39ce6a5da98c9abe20500036d90c1a527e0d538a5c79,196860143960
20170425,"PAYMENT RECEIVED",1431254432,0,2500c1aab0fffc92d916bc2b907a2aeef38ed47c964be35a633a1199259b71bb,195457437619
20170425,"PAYMENT RECEIVED",1382249587,0,0b84df7557e42a425fe25ececad61d4f06a3b34cc2f34dcc47deebbbded47946,194026183187
20170425,"PAYMENT RECEIVED",1412386689,0,aee6a87de38af32002596448c425a250e40f97580657e61f63866e3c105cd697,192643933600
20170425,"PAYMENT RECEIVED",1414587500,0,b1b1efdcaa2c63e2642830f45be734667e0884e87137d031e94be1ce8f70611d,191231546911
20170425,"PAYMENT RECEIVED",1403588970,0,a9cef41e5b23574e4f80acb8bc9d8ed98f0543ca8de6931d14e93a9e038ef132,189816959411
20170425,"PAYMENT RECEIVED",1431763792,0,0d6338777ccb9e954a2d106fa7bcb1a8d2c2da4ab621dbf9818384f507eb1778,188413370441
20170425,"PAYMENT RECEIVED",1508134384,0,c3fe5723ed33dd19611391ee45e9ea763a44d0b2a67c1418bc9c55e0753e2abd,186981606649
20170424,"PAYMENT RECEIVED",1441393750,0,b853af30ba54753f3e751e495e6c56573385d4ed7e1a586b2351c8472c4ea456,185473472265
20170424,"PAYMENT RECEIVED",1462549634,0,5fe143505b367bf0484bae0f20e198a6be073189140de3f0c4706aa13f85337e,184032078515
20170424,"PAYMENT RECEIVED",1469677894,0,a58a4fe2eecabba098477761174b33c01ecc91d808088b56e2e0269ff13213e1,182569528881
20170424,"PAYMENT RECEIVED",1452925005,0,ae4d15d64d74552ddc827afa7cb48d919e70fd5b26784775fc71f850ea858d38,181099850987
20170424,"PAYMENT RECEIVED",1476002514,0,53503148e6b9462c162eaab7d0634736a243b9dcaf57e6731d372c10a9cbc603,179646925982
20170424,"PAYMENT RECEIVED",1415154286,0,597ed8ffa712499ce2466fbb8a373e3b976b585f47ae9a8ce28e88ce4994ffe2,178170923468
20170424,"PAYMENT RECEIVED",1378742140,0,91bdc550b5f710823cce2126ef143ef4f12bd58cc20392296f30fe2063d5002b,176755769182
20170424,"PAYMENT RECEIVED",1405513466,0,6b2b9c3f954a1e4b6756e0fb10920c48bc5fb76b5949c4129f378833a4c5d284,175377027042
20170424,"PAYMENT RECEIVED",1356854630,0,5ead72fbb4eb2dc7f3542edfd30ee6fc0ec5ae4ce76e706251708800fe9260a2,173971513576
20170424,"PAYMENT RECEIVED",1375513432,0,8f202f59ab8e3da5a0036dce1bc6c122b58393f62801b7cf7a6ca20a9b36eb63,172614658946
20170424,"PAYMENT RECEIVED",1399314020,0,10c4e5121dfd09bce3c2116c304bad556227b596db71293bf95d5b4348963e6b,171239145514
20170424,"PAYMENT RECEIVED",1379773266,0,43295a8f238ff50589b19e9e0870b60a7e919d602f200680725729c43cebd8f3,169839831494
20170424,"PAYMENT RECEIVED",1302352243,0,b49451f229283cf184fc2f78c4d8ee44bba61a18859b780bae3b971c9b9dd8b9,168460058228
20170424,"PAYMENT RECEIVED",1364163834,0,756efeda115e36f44584e28d291622a3273bf0ee90927d3f4d7b2c46e34977eb,167157705985
20170424,"PAYMENT RECEIVED",1268207011,0,acdc07731b6bd77a964796e684a7a28147f9cb6fb728926a41438a48abaa7e1e,165793542151
20170424,"PAYMENT RECEIVED",1315357498,0,f011913d6d077a9a9fbd8a35c2a288348ea78313b4f4e93c1e6366dcde802c2c,164525335140
20170423,"PAYMENT RECEIVED",1404003011,0,172790088318b8f5b911b685999283946f2abfb1ab361fead63d95f7ac1a8231,163209977642
20170423,"PAYMENT RECEIVED",1277096874,0,938edc46edccf7a819cfde556736f7cbd82efd91d535dce44aa608e347aca666,161805974631
20170423,"PAYMENT RECEIVED",1261640584,0,ef2b04cbe720389658454955a43f4cf90fffca6c67430374c08f98ab9206f77c,160528877757
20170423,"PAYMENT RECEIVED",1355345415,0,b136867a429c3300b2ffe12aead9c731f0a4199290d283cde9ac8292aa35abda,159267237173
20170423,"PAYMENT RECEIVED",1338401069,0,6e5a003fa367e63734943f2969ae1c6b29750ce20d71026f1ddab4813d2f67fe,157911891758
20170423,"PAYMENT RECEIVED",1450809427,0,a709142f2e173af62b68c72064ad89515800af4d7562d8e1a8268a203a58cd22,156573490689
20170423,"PAYMENT RECEIVED",1392095662,0,a978515fd786a8aa167b5d15c2ec67b59720716bddb63afa6916478d5a2461e7,155122681262
20170423,"PAYMENT RECEIVED",1391455635,0,0ac1c66db7dffa9a0207ffe0a3562cc9c6a7ac6288bf3a7bfc01daafb23f57d1,153730585600
20170423,"PAYMENT RECEIVED",1504981314,0,60e7ddcd0dd8bd2af053c95bb4a7fd12227c537155020cac02c6adf7998051c5,152339129965
20170423,"PAYMENT RECEIVED",1421970099,0,1a2dba9cd2a787c4f64e35187f5a33ded72577b7880da9c38538b25f113962e0,150834148651
20170423,"PAYMENT RECEIVED",1323971346,0,db876d228def444d3b519f8977b9c8d2cf8c87f66b4097c191be77aab341ad6d,149412178552
20170422,"PAYMENT RECEIVED",1348087564,0,ce77a60f29bbaf6822526847dc1f964fed4a63b768b018bf9d0a99e1285fc8d6,148088207206
20170422,"PAYMENT RECEIVED",1314168597,0,41a4e8060d6c4aedec57c79e10da59262a5d24733e1d11bac88d57611c11d8cb,146740119642
20170422,"PAYMENT RECEIVED",1354901030,0,38451abff0ee63385a3b2ac5c71019d08b2c4911ba42b05a848dc5db49347271,145425951045
20170422,"PAYMENT RECEIVED",1356384019,0,0d7294315b390c87dcaed60310424747097d0c421e431de9637f7b765955569d,144071050015
20170422,"PAYMENT RECEIVED",1335390080,0,958f484d2e64b5097cf22168dd28073c3cf192c3e00ea8c8508aa1badd0a57c4,142714665996
20170422,"PAYMENT RECEIVED",1366966731,0,24abf817fbaa8ae4303611f0c1f27cbec50977fe0b644b616f40e01ec874d030,141379275916
20170422,"PAYMENT RECEIVED",1363569306,0,11a383b1fcdcc87c74446d5c3f5438d88c193fecc88664cdadc93ab586d085d5,140012309185
20170422,"PAYMENT RECEIVED",1396334693,0,076d625123cc059d96e97b59ef3db5ad1d585490b3c38c00dcbd2510e49fbd11,138648739879
20170422,"PAYMENT RECEIVED",1382428844,0,14c7a00b31425ce9559d09b183329832195dd497a469755d4cc560c7e3196e77,137252405186
20170422,"PAYMENT RECEIVED",1341766506,0,b413f25ba7d5c504c8e07ed9098e004e7b2e2dc1409e9721c6014c9e112541a8,135869976342
20170422,"PAYMENT RECEIVED",1352282740,0,1e489792a485e10ae4d9d7d495fa9056c245767bbc27081068cc39c9a1215d8e,134528209836
20170422,"PAYMENT RECEIVED",1290907108,0,95cde2d6706ff22d226c0e0641a9e0c6d5175dfba98cc78248b71a0930cdcf1d,133175927096
20170422,"PAYMENT RECEIVED",1296632891,0,7a572e6394a8a0b8db7cd67862687685e1826dd4fe0b91ed901fa4016e8857a4,131885019988
20170421,"PAYMENT RECEIVED",1333030229,0,a12efbe14355669d7d3368db67814ecffd39626732ccf85b860d206bbd98375a,130588387097
20170421,"PAYMENT RECEIVED",1407671806,0,ae58c68496f5dd764dcf4382d30e9a1d40133b0f9c6634ba9aeffed062683b3a,129255356868
20170421,"PAYMENT RECEIVED",1406079690,0,e25e109593267a86c492244a3f66e08ca26a5aa0f07d9b32fe4d19f552df6053,127847685062
20170421,"PAYMENT RECEIVED",1398377347,0,0a01b072215a6d13e188e029e78eb3979d59ccf58c9ac196a3651bbfb4bb2e13,126441605372
20170421,"PAYMENT RECEIVED",1357671454,0,eb0e741aa2ddb48841474aca4821824b04278cdf360a5e3cfa27dea892e1ac16,125043228025
20170421,"PAYMENT RECEIVED",1331921235,0,3a392670d4fcbfe86a09cc1c28120875d66db8437c1e5cc526deb27b4384e3e0,123685556571
20170421,"PAYMENT RECEIVED",1361553523,0,9940b836cdd1e0e122ed5fe8d1d5ff70fbae19f180461e4e2b36c0a58035ba51,122353635336
20170421,"PAYMENT RECEIVED",1408425752,0,5dd3981d6fa9fef59fc4e654893aeadfeb069dcf2ff133a56cd00a9446f8fbf3,120992081813
20170420,"PAYMENT RECEIVED",1450679101,0,6ca2978690fb4a6c42831dcc469a66a0aa760594bb496e5f7f3c226835012a7b,119583656061
20170420,"PAYMENT RECEIVED",1384376704,0,917093834d608b509ad242625f1734ead431e6ba8d3835655077e2cb596de3f4,118132976960
20170420,"PAYMENT RECEIVED",1401045567,0,80422c7c0ea6066edacdb02314049c97ce79342bc09ae8759a3001dc730f170b,116748600256
20170420,"PAYMENT RECEIVED",1419411708,0,0bf34a307ffdf2350d691a4543524f0a6167cb3dbb7224b8030e0162fcd516ae,115347554689
20170420,"PAYMENT RECEIVED",1432767891,0,84889a1488da2b6a5aaebffbaaf128946bbe6b135c5457a3d4fef8a59a44f644,113928142981
20170420,"PAYMENT RECEIVED",1475786240,0,6a4a0791931432ed580680879cb3d19a2977fc606e7e1bb3a41b0fc4b0ff86c3,112495375090
20170420,"PAYMENT RECEIVED",1434603193,0,f260402d1101ed5805fa88961d68ed15450b6e72e8fac90490b749bc84760686,111019588850
20170420,"PAYMENT RECEIVED",1385014337,0,5879f969cb36389077e48366be34a32d6698886f5098347f39554efb31cb2ef7,109584985657
20170420,"PAYMENT RECEIVED",1350245856,0,02eb54a9b2b55ab8403232c02a8b89726890e1013dd5f0833c0c0494aa28e4d7,108199971320
20170420,"PAYMENT RECEIVED",1363893197,0,153b1c23611c8f0d4eec146e3842d9f8da0692beba0799a65094600d772a6f89,106849725464
20170420,"PAYMENT RECEIVED",1379321129,0,03bafe4cb32b5a216f9eaa1376a138bf536675adeb0611c8412dd45883b8ee02,105485832267
20170420,"PAYMENT RECEIVED",1384502404,0,c18a9cfd4130507606c8449095c0fa98d06a3185e3ad5e4b22bc9dd0cb32a19c,104106511138
20170420,"PAYMENT RECEIVED",1343713114,0,f711b444a9ea155d4b7409ebcf387bf5e791e2383e24252101846657e18e005b,102722008734
20170420,"PAYMENT RECEIVED",1399524266,0,c7548996b06f01ca9316e2031aea41d00d375e0acc20601581bb4f5041de38e7,101378295620
20170420,"PAYMENT RECEIVED",1351789128,0,f2e97739fc8f70c009d2d0e8f2ad8691c2849b83d2450f7b230d1dcb9867217b,99978771354
20170419,"PAYMENT RECEIVED",1348990822,0,89d377f298bae5fffdf271705390b2e2998e13a8514e385c08de0b79f2392a80,98626982226
20170419,"PAYMENT RECEIVED",1388278192,0,3947aa9165f767ba4c5ea78dbc51303f4f6d8425f61e1bcd2689eace1ede0a88,97277991404
20170419,"PAYMENT RECEIVED",1410944486,0,7b5e8c7084f06a830787f62c6340de33f98d8340cc3623374ece0c2960fbd8f0,95889713212
20170419,"PAYMENT RECEIVED",1366365575,0,e75de7cedf36eb4ff416c42c3418b7429e6f58d20c94c848eb565bda40e22ff2,94478768726
20170419,"PAYMENT RECEIVED",1367701704,0,ab844f588c31c6d8c6a7a3498a2383154ef11cdd39f781adab81d6123bedce72,93112403151
20170419,"PAYMENT RECEIVED",1384006272,0,244b0e38b2238f2eca1efb3ce0d9048956eebf4ea38d9952411759b214cfad43,91744701447
20170419,"PAYMENT RECEIVED",1346540623,0,bab0f8ae746d7a0588d62ab81dc87f16d6e2274a441752298e6a7a6e7caf2e5d,90360695175
20170418,"PAYMENT RECEIVED",1371253728,0,49cdb3869d7e91ba571169ec3e49c81cf1f0d22d52f491d3590c37261e3508f3,89014154552
20170418,"PAYMENT RECEIVED",1446682375,0,e0792f5013cf17319fb7ac5c978612d4808c7cb54156e9f5797b323c651b8efb,87642900824
20170418,"PAYMENT RECEIVED",1432824880,0,6d15e74336d49fba15693fbee4e3d565f4d9914b77f82d6a16c1a2714d048b65,86196218449
20170418,"PAYMENT RECEIVED",1421874771,0,43638d168eeeb6b874ca6a3f6fcf34d920e7316b6b5d10b388b3b4e2abe115cb,84763393569
20170418,"PAYMENT RECEIVED",1373920341,0,80737844c169e9443697447e7b3349df1b8cc0abd14bf4c2c91e7c7edfbd1e6d,83341518798
20170418,"PAYMENT RECEIVED",1410272065,0,167dd933e3171b9dc9d9f560a0c5c0c5986dad230dcd4f34e2d34d583136f99f,81967598457
20170418,"PAYMENT RECEIVED",1379054881,0,382281abc6793b932b9acc72a88d448faaae9aa8e0cf26380e74c01f8b2d7cea,80557326392
20170418,"PAYMENT SENT",0,-30236754091,f31f947a91ef8d420778f2126f5c293d1b98a8af9d744d239503be3699e4f0bb,79178271511
20170418,"PAYMENT SENT",0,-11440631788,4a3d6d6bcbbb654c989c4d56e49a6cbcbd02fc1efc235e391a4280de5a2ee35a,118923124233
20170418,"PAYMENT SENT",0,-5023791629,4317c708824a5f51f513501c54399ec57e5e9a4798c2b26ad1f7969c409d57f9,113899332604
20170418,"PAYMENT SENT",0,-4484307002,57d6ec7951bc0f07b89ea50f4188b98d5fc2dd4d4e2e78f7fb92992459907e34,109415025602
20170418,"PAYMENT RECEIVED",1492985551,0,f37b4493adffd6504fda95ee467411305f3e3b8aec5edc97ba9510407673c9b3,130363756021
20170418,"PAYMENT RECEIVED",1416298979,0,5cb66f62a6d129ad7e08d39278cad52ed52f8d16398a1056c51e5655ea6f48dc,128870770470
20170418,"PAYMENT RECEIVED",1384073210,0,3e3f9cacaf0c7928733321f4e53b17db68169deb0e8f1bbf68348d8ae813446e,127454471491
20170418,"PAYMENT RECEIVED",1377363413,0,5889fefef3eee5afad5efd4e28d6f7d1c3530613bbe62698ccbb9fa2ea04934c,126070398281
20170418,"PAYMENT RECEIVED",1362144624,0,1581e6683fc98009819acd439ebd157787089b0e8dcb1eb0241bb1c2b58f0986,124693034868
20170418,"PAYMENT RECEIVED",1395993120,0,871d4cea0251daf3d20a3ea12bf8e94fb4d71204483d118fc190b9ef61bae4f9,123330890244
20170418,"PAYMENT RECEIVED",1415638718,0,76791ca44b33bd8e034600cebd1988e516d08aee1f0b752cb3a1e37fa05674e5,121934897124
20170418,"PAYMENT RECEIVED",1394884095,0,5ab24276ffaff2d7e27ea8ebfbd12911a3dec4a205859e6154c5cfee5763b654,120519258406
20170418,"PAYMENT RECEIVED",1400717481,0,a37e72f21069b07352112bb86ca6bde59c4ed107af2bb73995a1f8f4072bfc91,119124374311
20170417,"PAYMENT RECEIVED",1400809417,0,ca8ebdd61e25e2c74a98ba68e43eb154e42fe40a16e4e257faee4ef963d89ed2,117723656830
20170417,"PAYMENT RECEIVED",1414946609,0,824012204526a307faa5824fd83c5986d6be09291ced87009482cc397e628fcf,116322847413
20170417,"PAYMENT RECEIVED",1362721710,0,8c5bb2790f361ff12152ccbdc8149b42294a165e767ef042d0fb0b012d552e0a,114907900804
20170417,"PAYMENT SENT",0,-50047200,ec0e21d3318a38e93af06a516c9530b9f38b3edc729df26e659f946122f99aa1,113545179094
20170417,"PAYMENT RECEIVED",1340181032,0,9ff0cf46bdca6e93ce8576eaae8a95f129292c562d8df202b6120f8bfe4eb856,113595226294
20170417,"PAYMENT RECEIVED",1345416337,0,cab044cad60f9a6ffeda533e3f2235b18d6f1d7f5159ba2440b18ed70c1f1e56,112255045262
20170417,"PAYMENT RECEIVED",1304785970,0,5bd019820abee8521af9155349adece334566758ae6f1685de65b646262931b0,110909628925
20170417,"PAYMENT RECEIVED",1406918856,0,bf9ecc430f97f5c5aa4b07e638c46c1b8864b0d8b86c8dfb5b1485e12c4d1dd3,109604842955
20170417,"PAYMENT RECEIVED",1322193954,0,896d4551034d0cc2f4aaf7714f44f142392f2f3748e10816302fd5bc9698c56d,108197924099
20170417,"PAYMENT RECEIVED",1268894650,0,50bbca184713c617c16cf96db672c7ba70d77d96606835bc8dbe47fe2c60ae25,106875730145
20170417,"PAYMENT RECEIVED",1299339684,0,819671c31d61ade61ae1b89124c0ce1cd1b28e93d6c1f239c8f8314ce0c09802,105606835495
20170417,"PAYMENT RECEIVED",1334814822,0,7e2579a604d71cfb86b3c0279fb022b67ece429ebe2423330b044fe8d2a15750,104307495811
20170416,"PAYMENT RECEIVED",1349492913,0,19122ed6cced1684eef623824446be7be101ac71168170020ab14240a3f66f81,102972680989
20170416,"PAYMENT RECEIVED",1370527541,0,19ceafc984b046926bcf8d2dcaa0c276bc04276ab6a15418de5d15c90e78d14e,101623188076
20170416,"PAYMENT RECEIVED",1283543505,0,7224b1dc7ad1f07393a5dd8366b7d7b550d6ae3e49fbe6d1a1a2c9ad684d4ec3,100252660535
20170416,"PAYMENT RECEIVED",1344357099,0,bb2748a6314845d15a18d92baa1fb513fe3a99d0af8cdbf7dbd9e9f8ffb781c9,98969117030
20170416,"PAYMENT RECEIVED",1334600873,0,fccd378acabceb82a94262c40320034aee01b4eff5f1698f399772c8b89c24cc,97624759931
20170416,"PAYMENT RECEIVED",1409912641,0,dc7a674632e4cc490db81b52453c9b9513fbfbb4fc8db5e8b9980cc43ee926ce,96290159058
20170416,"PAYMENT RECEIVED",1266404860,0,04dc96c3afb5ca49382c1d9f6ff1b4116c0028431a1c0802ae088789dbe6ca4a,94880246417
20170416,"PAYMENT RECEIVED",1334515663,0,555ff7aeba6887516a36fe9d5bb9b9bd22403689a9cde2152a1f09cbeb025bcc,93613841557
20170416,"PAYMENT RECEIVED",1366722645,0,e6ab1af986470865d4770e5236e4087853574bcba67921e0a89e0b90ae372887,92279325894
20170416,"PAYMENT RECEIVED",1294214619,0,a7ff582747ecaa2981aeed236b82a6c42e69abf1f649a3084a348cf57593d565,90912603249
20170416,"PAYMENT RECEIVED",1371504288,0,47febbacc7bf65effa819c4028806e22172d9ba52f83ef6b6392625856da0976,89618388630
20170416,"PAYMENT RECEIVED",1302721762,0,02b1f7c564765802e34cd7c950053e7ab4598ef40ea6b338a2cf61766306695f,88246884342
20170416,"PAYMENT RECEIVED",1429372994,0,164b5812e571f1fe5aecc9e7c4db4fa309ca87b5ca1f4a4a0f35d7f6aee0c2f2,86944162580
20170416,"PAYMENT RECEIVED",1351187985,0,04b81d77e0c1322057e0ad06481a52c63beb997cdcebfbd08027b16161ecc461,85514789586
20170416,"PAYMENT RECEIVED",1399057358,0,76d70252b45512473e4aa986e27d6e3c7ff5f3505604044f055135677f7ccb84,84163601601
20170416,"PAYMENT RECEIVED",1306909740,0,8cfdf9d077be47a98de2e6e7033c4c9ff0b32b0be89a77598dc1766c83c1eabf,82764544243
20170416,"PAYMENT RECEIVED",1405845091,0,c9c84bd3af40b08cd76f0791d77627f1872229f74ae33f51d81e4c82d384a77b,81457634503
20170416,"PAYMENT RECEIVED",1286755462,0,97870a2f4b3ae402ae4a114df64870dd2b5166c95015b95afbacb69571b372d8,80051789412
20170415,"PAYMENT RECEIVED",1276756197,0,8825eb4d32a835fbc85c99b110a94f16e5d18d5f9a9a50a9cf0f781a67fc2c7f,78765033950
20170415,"PAYMENT RECEIVED",1389990259,0,2c484f6c8f7e86bcf261d2140fa52622f4dfc48d8b89b60e895c2387ba54f9f6,77488277753
20170415,"PAYMENT RECEIVED",1359401625,0,39a57b84d1c2b119f8257f865f58a21f2ca76f0393745fee31201ddff42c3537,76098287494
20170415,"PAYMENT RECEIVED",1360050482,0,0477723915efe81b7e0000e78f385c53266653fbd0c81b62e01dc410015eb5dc,74738885869
20170415,"PAYMENT RECEIVED",1330085100,0,d6551a60f8945db6c9500a0ce35973b5184844a74fba488f534895d1dbdc37d1,73378835387
20170415,"PAYMENT RECEIVED",1390273118,0,2ade4391b5a13a84f8c6994043f830769d81e3d6eab5871c7dec42554feeed67,72048750287
20170415,"PAYMENT RECEIVED",1429793558,0,a51f7f51ae5b6894467d0f0517569b0a351999625d29a167962c6a385d6aa469,70658477169
20170415,"PAYMENT RECEIVED",1426311089,0,3e15907f7cc851537ea6b3ba8f97ca13e119dd8ab6de3171e6ef469c5af495ef,69228683611
20170415,"PAYMENT RECEIVED",1371201810,0,ae5269f7062103a8e0a0274dcc227ad7406694147f40d4c8d8e047e95839e56a,67802372522
20170415,"PAYMENT RECEIVED",1318239584,0,036271176be7c0704d260ba20675c54d24d93e943a35d2feca3cd74624219dde,66431170712
20170415,"PAYMENT RECEIVED",1305602680,0,3388bf3f191478ac9b3352ac922e5094cb32b334d3e1978d45bcf56d23a6a0c2,65112931128
20170415,"PAYMENT RECEIVED",1345676701,0,54d86243925f6e22528cbda32a4407ecddbd59d492e6d7299b62aed4798f50a6,63807328448
20170415,"PAYMENT RECEIVED",1393624710,0,5a1e869b26052357143e729215e4c8c04e75be5a5914ab3df3629cf2608dcd7c,62461651747
20170415,"PAYMENT RECEIVED",1407908040,0,4697f180b1057b88944fae45d71a3daf3a1fc347bb309addf7c84497815f257f,61068027037
20170415,"PAYMENT RECEIVED",1357580596,0,ec3f06088721a22f493bb4c809efa6ad2196432e274fc2a2acc2894e135f22cd,59660118997
20170414,"PAYMENT RECEIVED",1366456108,0,19643ac59c4590874349764510fcb9a566f5e52c40a786369a3f0a9355c2fb45,58302538401
20170414,"PAYMENT RECEIVED",1526457865,0,817683528bddc579519b76621120db087c2f9c9ed3dab16070c17d998e8af000,56936082293
20170414,"PAYMENT RECEIVED",1355417177,0,3c8b73cb846ba0c1d2aa953f68810ebef477f906723fd231f9e2a1097555df52,55409624428
20170414,"PAYMENT RECEIVED",1386902898,0,a0de3a5d20c124c8a62e5c2b10b693c8907b22447108e3ec29d8d1036d76fb35,54054207251
20170414,"PAYMENT RECEIVED",1390032340,0,f637b68a0a367dcfd04639334529fda92f3b29489deca6e5bc7ba1a1d59bec45,52667304353
20170414,"PAYMENT RECEIVED",1401211499,0,d719fced70c78bf238739fc60d8d52888b531e9917ecb89e58a6b85ba78ec157,51277272013
20170414,"PAYMENT RECEIVED",1432423931,0,a7a44ff073aa8b901d342bdde82efe0e0e36dd3f2023251ce74f69987a1a4192,49876060514
20170414,"PAYMENT RECEIVED",1396580496,0,fe082719d8d746c1e6b75b9d712e7d08e6abc553d1b0bc7162519f4bf6b6f20d,48443636583
20170414,"PAYMENT RECEIVED",1458248716,0,2f8ee9c3fbac2cd9ddbca53725b398df9d44c960b3894606ef494bbd0c231b8c,47047056087
20170414,"PAYMENT RECEIVED",1343940478,0,ec06abb3ecdf77e2b5622a4bf25a008e81740d8f34580f040339a6917bc78f05,45588807371
20170414,"PAYMENT RECEIVED",1414803243,0,d42e9073af15629123e103a8051ad0efc6052659b754e4b3a56518bb986c3115,44244866893
20170414,"PAYMENT RECEIVED",1417937136,0,84f5176c9341021898a1b70c90ee46c8904db084de880ef887f0ca771f578e54,42830063650
20170413,"PAYMENT RECEIVED",1465839920,0,fe0bff4b02016acbe50e6c7097cfdce3b26bebcec21c94e9cfb640d2944e2992,41412126514
20170413,"PAYMENT RECEIVED",1461012614,0,08325679e4f8aacd59f07f7ac38197c0cef7710430582cd93a8e7fc934e4a44c,39946286594
20170413,"PAYMENT RECEIVED",1436959293,0,1f8391a5af9dc12ca2e6d27063e5d9e06acf4db341b9535475360a5b90738bb5,38485273980
20170413,"PAYMENT RECEIVED",1593042609,0,90c5fa4b600fb1271f5d495f24ec392026717f162c3f2cfce4b198a073c38aec,37048314687
20170413,"PAYMENT SENT",0,-400002076800,d253d84205108de3ee59b285191b5b89c192748ff0b50a508dd05f7fb73b31e0,35455272078
